acxxh	umjudwgothewbadwgbekm
acyxh	umiudwgpthewaadwgcekm
aczxh	umhudwgqthewzadwgdekm
adaxh	ulgudwhrthevyadwheekm
adbxh	ulfudwhsthevxadwhfekm
adcle	uleggwhtheevwmgwhgshm
adcxh	uleudwhtthevwadwhgekm
addxh	uldudwhuthevvadwhhekm
adexh	ulcudwhvthevuadwhiekm
adfqg	ulbbewhwmgevthewhjxjm
adfxh	ulbudwhwthevtadwhjekm
adgxh	ulaudwhxthevsadwhkekm
adhxh	ulzudwhythevradwhlekm
adixh	ulyudwhzthevqadwhmekm
adjxh	ulxudwhathevpadwhnekm
adkxh	ulwudwhbthevoadwhoekm
adlxh	ulvudwhcthevnadwhpekm
admxh	uluudwhdthevmadwhqekm
adnkg	ulthewheggevlnewhrrjm
adnxh	ultudwhethevladwhrekm
adoxh	ulsudwhfthevkadwhsekm
adpab	ulrrjwhgwbevjxjwhthem
adpxh	ulrudwhgthevjadwhtekm
adqxh	ulqudwhhtheviadwhuekm
adrxh	ulpudwhithevhadwhvekm
adsxh	uloudwhjthevgadwhwekm
adtxh	ulnudwhkthevfadwhxekm
aduxh	ulmudwhltheveadwhyekm
advxh	ulludwhmthevdadwhzekm
adwxh	ulkudwhnthevcadwhaekm
adxxh	uljudwhothevbadwhbekm
adyxh	uliudwhpthevaadwhcekm
adzxh	ulhudwhqthevzadwhdekm
aeaxh	ukgudwirtheuyadwieekm
aebxh	ukfudwistheuxadwifekm
aecle	ukeggwitheeuwmgwigshm
aecxh	ukeudwittheuwadwigekm
aedxh	ukdudwiutheuvadwihekm
aeexh	ukcudwivtheuuadwiiekm
aefqg	ukbbewiwmgeuthewijxjm
aefxh	ukbudwiwtheutadwijekm
aegxh	ukaudwixtheusadwikekm
aehxh	ukzudwiytheuradwilekm
aeixh	ukyudwiztheuqadwimekm
aejxh	ukxudwiatheupadwinekm
aekxh	ukwudwibtheuoadwioekm
aelxh	ukvudwictheunadwipekm
aemxh	ukuudwidtheumadwiqekm
aenkg	ukthewieggeulnewirrjm
aenxh	uktudwietheuladwirekm
aeoxh	uksudwiftheukadwisekm
aepab	ukrrjwigwbeujxjwithem
aepxh	ukrudwigtheujadwitekm
aeqxh	ukqudwihtheuiadwiuekm
aerxh	ukpudwiitheuhadwivekm
aesxh	ukoudwijtheugadwiwekm
aetxh	uknudwiktheufadwixekm
aeuxh	ukmudwiltheueadwiyekm
aevxh	ukludwimtheudadwizekm
aewxh	ukkudwintheucadwiaekm
aexxh	ukjudwiotheubadwibekm
aeyxh	ukiudwiptheuaadwicekm
aezxh	ukhudwiqtheuzadwidekm
afaxh	ujgudwjrthetyadwjeekm
afbxh	ujfudwjsthetxadwjfekm
afcle	ujeggwjtheetwmgwjgshm
afcxh	ujeudwjtthetwadwjgekm
afdxh	ujdudwjuthetvadwjhekm
afexh	ujcudwjvthetuadwjiekm
affqg	ujbbewjwmgetthewjjxjm
affxh	ujbudwjwthettadwjjekm
afgxh	ujaudwjxthetsadwjkekm
afhxh	ujzudwjythetradwjlekm
afixh	ujyudwjzthetqadwjmekm
afjxh	ujxudwjathetpadwjnekm
afkxh	ujwudwjbthetoadwjoekm
aflxh	ujvudwjcthetnadwjpekm
afmxh	ujuudwjdthetmadwjqekm
afnkg	ujthewjeggetlnewjrrjm
afnxh	ujtudwjethetladwjrekm
afoxh	ujsudwjfthetkadwjsekm
afpab	ujrrjwjgwbetjxjwjthem
afpxh	ujrudwjgthetjadwjtekm
afqxh	ujqudwjhthetiadwjuekm
afrta	ujpykwjipaethekwjvadm
afrxh	ujpudwjithethadwjvekm
afsxh	ujoudwjjthetgadwjwekm
aftxh	ujnudwjkthetfadwjxekm
afuxh	ujmudwjltheteadwjyekm
afvxh	ujludwjmthetdadwjzekm
afwxh	ujkudwjnthetcadwjaekm
afxxh	ujjudwjothetbadwjbekm
afyxh	ujiudwjpthetaadwjcekm
afzxh	ujhudwjqthetzadwjdekm
agaxh	uigudwkrthesyadwkeekm
agbxh	uifudwksthesxadwkfekm
agcle	uieggwktheeswmgwkgshm
agcxh	uieudwkttheswadwkgekm
agdxh	uidudwkuthesvadwkhekm
agexh	uicudwkvthesuadwkiekm
agfqg	uibbewkwmgesthewkjxjm
agfxh	uibudwkwthestadwkjekm
aggxh	uiaudwkxthessadwkkekm
aghxh	uizudwkythesradwklekm
agixh	uiyudwkzthesqadwkmekm
agjxh	uixudwkathespadwknekm
agkxh	uiwudwkbthesoadwkoekm
aglxh	uivudwkcthesnadwkpekm
agmxh	uiuudwkdthesmadwkqekm
agnkg	uithewkeggeslnewkrrjm
agnxh	uitudwkethesladwkrekm
agoxh	uisudwkftheskadwksekm
agpab	uirrjwkgwbesjxjwkthem
agpxh	uirudwkgthesjadwktekm
agqxh	uiqudwkhthesiadwkuekm
agrxh	uipudwkitheshadwkvekm
agsxh	uioudwkjthesgadwkwekm
agtxh	uinudwkkthesfadwkxekm
aguxh	uimudwkltheseadwkyekm
agvxh	uiludwkmthesdadwkzekm
agwxh	uikudwknthescadwkaekm
agxxh	uijudwkothesbadwkbekm
agyxh	uiiudwkpthesaadwkcekm
agzxh	uihudwkqtheszadwkdekm
ahaxh	uhgudwlrtheryadwleekm
ahbxh	uhfudwlstherxadwlfekm
ahcle	uheggwltheerwmgwlgshm
ahcxh	uheudwlttherwadwlgekm
ahdxh	uhdudwluthervadwlhekm
ahexh	uhcudwlvtheruadwliekm
ahfqg	uhbbewlwmgerthewljxjm
ahfxh	uhbudwlwthertadwljekm
ahgxh	uhaudwlxthersadwlkekm
ahhxh	uhzudwlytherradwllekm
ahixh	uhyudwlztherqadwlmekm
ahjxh	uhxudwlatherpadwlnekm
ahkxh	uhwudwlbtheroadwloekm
ahlxh	uhvudwlcthernadwlpekm
ahmxh	uhuudwldthermadwlqekm
ahnkg	uhthewleggerlnewlrrjm
ahnxh	uhtudwletherladwlrekm
ahoxh	uhsudwlftherkadwlsekm
ahpab	uhrrjwlgwberjxjwlthem
ahpxh	uhrudwlgtherjadwltekm
ahqxh	uhqudwlhtheriadwluekm
ahrxh	uhpudwlitherhadwlvekm
ahsxh	uhoudwljthergadwlwekm
ahtxh	uhnudwlktherfadwlxekm
ahuxh	uhmudwllthereadwlyekm
ahvxh	uhludwlmtherdadwlzekm
ahwxh	uhkudwlnthercadwlaekm
ahxxh	uhjudwlotherbadwlbekm
ahyxh	uhiudwlptheraadwlcekm
ahzxh	uhhudwlqtherzadwldekm
aiaxh	uggudwmrtheqyadwmeekm
aibxh	ugfudwmstheqxadwmfekm
aicle	ugeggwmtheeqwmgwmgshm
aicxh	ugeudwmttheqwadwmgekm
aidxh	ugdudwmutheqvadwmhekm
aiexh	ugcudwmvthequadwmiekm
aifqg	ugbbewmwmgeqthewmjxjm
aifxh	ugbudwmwtheqtadwmjekm
aigxh	ugaudwmxtheqsadwmkekm
aihxh	ugzudwmytheqradwmlekm
aiixh	ugyudwmztheqqadwmmekm
aijxh	ugxudwmatheqpadwmnekm
aikxh	ugwudwmbtheqoadwmoekm
ailxh	ugvudwmctheqnadwmpekm
aimxh	uguudwmdtheqmadwmqekm
ainkg	ugthewmeggeqlnewmrrjm
ainxh	ugtudwmetheqladwmrekm
aioxh	ugsudwmftheqkadwmsekm
aipab	ugrrjwmgwbeqjxjwmthem
aipxh	ugrudwmgtheqjadwmtekm
aiqxh	ugqudwmhtheqiadwmuekm
airxh	ugpudwmitheqhadwmvekm
aisxh	ugoudwmjtheqgadwmwekm
aitxh	ugnudwmktheqfadwmxekm
aiuxh	ugmudwmltheqeadwmyekm
aivxh	ugludwmmtheqdadwmzekm
aiwxh	ugkudwmntheqcadwmaekm
aixxh	ugjudwmotheqbadwmbekm
aiyxh	ugiudwmptheqaadwmcekm
aizxh	ughudwmqtheqzadwmdekm
ajaxh	ufgudwnrthepyadwneekm
ajbxh	uffudwnsthepxadwnfekm
ajcle	ufeggwntheepwmgwngshm
ajcxh	ufeudwntthepwadwngekm
ajdxh	ufdudwnuthepvadwnhekm
ajexh	ufcudwnvthepuadwniekm
ajfqg	ufbbewnwmgepthewnjxjm
ajfxh	ufbudwnwtheptadwnjekm
ajgxh	ufaudwnxthepsadwnkekm
ajhxh	ufzudwnythepradwnlekm
ajixh	ufyudwnzthepqadwnmekm
ajjxh	ufxudwnatheppadwnnekm
ajkxh	ufwudwnbthepoadwnoekm
ajlxh	ufvudwncthepnadwnpekm
ajmxh	ufuudwndthepmadwnqekm
ajnkg	ufthewneggeplnewnrrjm
ajnxh	uftudwnethepladwnrekm
ajoxh	ufsudwnfthepkadwnsekm
ajpab	ufrrjwngwbepjxjwnthem
ajpxh	ufrudwngthepjadwntekm
ajqxh	ufqudwnhthepiadwnuekm
ajrxh	ufpudwnithephadwnvekm
ajsxh	ufoudwnjthepgadwnwekm
ajtxh	ufnudwnkthepfadwnxekm
ajuxh	ufmudwnlthepeadwnyekm
ajvxh	ufludwnmthepdadwnzekm
ajwxh	ufkudwnnthepcadwnaekm
ajxxh	ufjudwnothepbadwnbekm
ajyxh	ufiudwnpthepaadwncekm
ajzxh	ufhudwnqthepzadwndekm
akaxh	uegudwortheoyadwoeekm
akbxh	uefudwostheoxadwofekm
akcle	ueeggwotheeowmgwogshm
akcxh	ueeudwottheowadwogekm
akdxh	uedudwoutheovadwohekm
akexh	uecudwovtheouadwoiekm
akfqg	uebbewowmgeothewojxjm
akfxh	uebudwowtheotadwojekm
akgxh	ueaudwoxtheosadwokekm
akhxh	uezudwoytheoradwolekm
akixh	ueyudwoztheoqadwomekm
akjxh	uexudwoatheopadwonekm
akkxh	uewudwobtheooadwooekm
aklxh	uevudwoctheonadwopekm
akmxh	ueuudwodtheomadwoqekm
aknkg	uethewoeggeolneworrjm
aknxh	uetudwoetheoladworekm
akoxh	uesudwoftheokadwosekm
akpab	uerrjwogwbeojxjwothem
akpxh	uerudwogtheojadwotekm
akqxh	uequdwohtheoiadwouekm
akrxh	uepudwoitheohadwovekm
aksxh	ueoudwojtheogadwowekm
aktxh	uenudwoktheofadwoxekm
akuxh	uemudwoltheoeadwoyekm
akvxh	ueludwomtheodadwozekm
akwxh	uekudwontheocadwoaekm
akxxh	uejudwootheobadwobekm
akyxh	ueiudwoptheoaadwocekm
akzxh	uehudwoqtheozadwodekm
alaxh	udgudwprthenyadwpeekm
albxh	udfudwpsthenxadwpfekm
alcle	udeggwptheenwmgwpgshm
alcxh	udeudwptthenwadwpgekm
aldxh	uddudwputhenvadwphekm
alexh	udcudwpvthenuadwpiekm
alfqg	udbbewpwmgenthewpjxjm
alfxh	udbudwpwthentadwpjekm
algxh	udaudwpxthensadwpkekm
alhxh	udzudwpythenradwplekm
alixh	udyudwpzthenqadwpmekm
aljxh	udxudwpathenpadwpnekm
alkxh	udwudwpbthenoadwpoekm
allxh	udvudwpcthennadwppekm
almxh	uduudwpdthenmadwpqekm
alnkg	udthewpeggenlnewprrjm
alnxh	udtudwpethenladwprekm
aloxh	udsudwpfthenkadwpsekm
alpab	udrrjwpgwbenjxjwpthem
alpxh	udrudwpgthenjadwptekm
alqxh	udqudwphtheniadwpuekm
alrxh	udpudwpithenhadwpvekm
alsxh	udoudwpjthengadwpwekm
altxh	udnudwpkthenfadwpxekm
aluxh	udmudwpltheneadwpyekm
alvxh	udludwpmthendadwpzekm
alwxh	udkudwpnthencadwpaekm
alxxh	udjudwpothenbadwpbekm
alyxh	udiudwppthenaadwpcekm
alzxh	udhudwpqthenzadwpdekm
amaxh	ucgudwqrthemyadwqeekm
ambxh	ucfudwqsthemxadwqfekm
amcle	uceggwqtheemwmgwqgshm
amcxh	uceudwqtthemwadwqgekm
amdxh	ucdudwquthemvadwqhekm
amexh	uccudwqvthemuadwqiekm
amfqg	ucbbewqwmgemthewqjxjm
amfxh	ucbudwqwthemtadwqjekm
amgxh	ucaudwqxthemsadwqkekm
amhxh	uczudwqythemradwqlekm
amixh	ucyudwqzthemqadwqmekm
amjxh	ucxudwqathempadwqnekm
amkxh	ucwudwqbthemoadwqoekm
amlxh	ucvudwqcthemnadwqpekm
ammxh	ucuudwqdthemmadwqqekm
amnkg	ucthewqeggemlnewqrrjm
amnxh	uctudwqethemladwqrekm
amoxh	ucsudwqfthemkadwqsekm
ampab	ucrrjwqgwbemjxjwqthem
ampxh	ucrudwqgthemjadwqtekm
amqxh	ucqudwqhthemiadwquekm
amrxh	ucpudwqithemhadwqvekm
amsxh	ucoudwqjthemgadwqwekm
amtxh	ucnudwqkthemfadwqxekm
amuxh	ucmudwqlthemeadwqyekm
amvxh	ucludwqmthemdadwqzekm
amwxh	uckudwqnthemcadwqaekm
amxxh	ucjudwqothembadwqbekm
amyxh	uciudwqpthemaadwqcekm
amzxh	uchudwqqthemzadwqdekm
anaxh	ubgudwrrthelyadwreekm
anbxh	ubfudwrsthelxadwrfekm
ancle	ubeggwrtheelwmgwrgshm
ancxh	ubeudwrtthelwadwrgekm
andxh	ubdudwruthelvadwrhekm
anexh	ubcudwrvtheluadwriekm
anfqg	ubbbewrwmgelthewrjxjm
anfxh	ubbudwrwtheltadwrjekm
angxh	ubaudwrxthelsadwrkekm
anhxh	ubzudwrythelradwrlekm
anixh	ubyudwrzthelqadwrmekm
anjxh	ubxudwrathelpadwrnekm
ankxh	ubwudwrbtheloadwroekm
anlxh	ubvudwrcthelnadwrpekm
anmxh	ubuudwrdthelmadwrqekm
annkg	ubthewreggellnewrrrjm
annxh	ubtudwrethelladwrrekm
anoxh	ubsudwrfthelkadwrsekm
anpab	ubrrjwrgwbeljxjwrthem
anpxh	ubrudwrgtheljadwrtekm
anqxh	ubqudwrhtheliadwruekm
anrxh	ubpudwrithelhadwrvekm
ansxh	uboudwrjthelgadwrwekm
antxh	ubnudwrkthelfadwrxekm
anuxh	ubmudwrltheleadwryekm
anvxh	ubludwrmtheldadwrzekm
anwxh	ubkudwrnthelcadwraekm
anxxh	ubjudwrothelbadwrbekm
anyxh	ubiudwrpthelaadwrcekm
anzxh	ubhudwrqthelzadwrdekm
aoaxh	uagudwsrthekyadwseekm
aobxh	uafudwssthekxadwsfekm
aocle	uaeggwstheekwmgwsgshm
aocxh	uaeudwstthekwadwsgekm
aodxh	uadudwsuthekvadwshekm
aoexh	uacudwsvthekuadwsiekm
aofqg	uabbewswmgekthewsjxjm
aofxh	uabudwswthektadwsjekm
aogxh	uaaudwsxtheksadwskekm
aohxh	uazudwsythekradwslekm
aoixh	uayudwszthekqadwsmekm
aojxh	uaxudwsathekpadwsnekm
aokxh	uawudwsbthekoadwsoekm
aolxh	uavudwsctheknadwspekm
aomxh	uauudwsdthekmadwsqekm
aonkg	uathewseggeklnewsrrjm
aonxh	uatudwsethekladwsrekm
aooxh	uasudwsfthekkadwssekm
aopab	uarrjwsgwbekjxjwsthem
aopxh	uarudwsgthekjadwstekm
aoqxh	uaqudwshthekiadwsuekm
aorxh	uapudwsithekhadwsvekm
aosxh	uaoudwsjthekgadwswekm
aotxh	uanudwskthekfadwsxekm
aouxh	uamudwslthekeadwsyekm
aovxh	ualudwsmthekdadwszekm
aowxh	uakudwsnthekcadwsaekm
aoxxh	uajudwsothekbadwsbekm
aoyxh	uaiudwspthekaadwscekm
aozxh	uahudwsqthekzadwsdekm
apaxh	uzgudwtrthejyadwteekm
apbxh	uzfudwtsthejxadwtfekm
apcle	uzeggwttheejwmgwtgshm
apcxh	uzeudwttthejwadwtgekm
apdxa	uzdukwtutaejvakwthedm
apexh	uzcudwtvthejuadwtiekm
apfqg	uzbbewtwmgejthewtjxjm
apfxh	uzbudwtwthejtadwtjekm
apgxh	uzaudwtxthejsadwtkekm
aphxh	uzzudwtythejradwtlekm
apixh	uzyudwtzthejqadwtmekm
apjxh	uzxudwtathejpadwtnekm
apkxh	uzwudwtbthejoadwtoekm
aplxh	uzvudwtcthejnadwtpekm
apmxh	uzuudwtdthejmadwtqekm
apnkg	uzthewteggejlnewtrrjm
apnxh	uztudwtethejladwtrekm
apoxh	uzsudwtfthejkadwtsekm
appab	uzrrjwtgwbejjxjwtthem
appxh	uzrudwtgthejjadwttekm
apqia	uzqjkwtheaejipkwtupdm
apqxh	uzqudwththejiadwtuekm
aprxh	uzpudwtithejhadwtvekm
apsxh	uzoudwtjthejgadwtwekm
aptxh	uznudwtkthejfadwtxekm
apuxh	uzmudwtlthejeadwtyekm
apvxh	uzludwtmthejdadwtzekm
apwxh	uzkudwtnthejcadwtaekm
apxxh	uzjudwtothejbadwtbekm
apyxh	uziudwtpthejaadwtcekm
apzxh	uzhudwtqthejzadwtdekm
aqaxh	uygudwurtheiyadwueekm
aqbxh	uyfudwustheixadwufekm
aqcle	uyeggwutheeiwmgwugshm
aqcxh	uyeudwuttheiwadwugekm
aqdxh	uydudwuutheivadwuhekm
aqexh	uycudwuvtheiuadwuiekm
aqfqg	uybbewuwmgeithewujxjm
aqfxh	uybudwuwtheitadwujekm
aqgxh	uyaudwuxtheisadwukekm
aqhxh	uyzudwuytheiradwulekm
aqixh	uyyudwuztheiqadwumekm
aqjxh	uyxudwuatheipadwunekm
aqkxh	uywudwubtheioadwuoekm
aqlxh	uyvudwuctheinadwupekm
aqmxh	uyuudwudtheimadwuqekm
aqnkg	uythewueggeilnewurrjm
aqnxh	uytudwuetheiladwurekm
aqoxh	uysudwuftheikadwusekm
aqpab	uyrrjwugwbeijxjwuthem
aqpxh	uyrudwugtheijadwutekm
aqqxh	uyqudwuhtheiiadwuuekm
aqrxh	uypudwuitheihadwuvekm
aqsxh	uyoudwujtheigadwuwekm
aqtxh	uynudwuktheifadwuxekm
aquxh	uymudwultheieadwuyekm
aqvxh	uyludwumtheidadwuzekm
aqwxh	uykudwuntheicadwuaekm
aqxxh	uyjudwuotheibadwubekm
aqyxh	uyiudwuptheiaadwucekm
aqzxh	uyhudwuqtheizadwudekm
araxh	uxgudwvrthehyadwveekm
arbxh	uxfudwvsthehxadwvfekm
arcle	uxeggwvtheehwmgwvgshm
arcxh	uxeudwvtthehwadwvgekm
ardxh	uxdudwvuthehvadwvhekm
arexh	uxcudwvvthehuadwviekm
arfqg	uxbbewvwmgehthewvjxjm
arfxh	uxbudwvwthehtadwvjekm
argxh	uxaudwvxthehsadwvkekm
arhxh	uxzudwvythehradwvlekm
arixh	uxyudwvzthehqadwvmekm
arjxh	uxxudwvathehpadwvnekm
arkxh	uxwudwvbthehoadwvoekm
arlxh	uxvudwvcthehnadwvpekm
armxh	uxuudwvdthehmadwvqekm
arnkg	uxthewveggehlnewvrrjm
arnxh	uxtudwvethehladwvrekm
aroxh	uxsudwvfthehkadwvsekm
arpab	uxrrjwvgwbehjxjwvthem
arpxh	uxrudwvgthehjadwvtekm
arqxh	uxqudwvhthehiadwvuekm
arrxh	uxpudwvithehhadwvvekm
arsxh	uxoudwvjthehgadwvwekm
artxh	uxnudwvkthehfadwvxekm
aruxh	uxmudwvltheheadwvyekm
arvxh	uxludwvmthehdadwvzekm
arwxh	uxkudwvnthehcadwvaekm
arxxh	uxjudwvothehbadwvbekm
aryxh	uxiudwvpthehaadwvcekm
arzxh	uxhudwvqthehzadwvdekm
asaxh	uwgudwwrthegyadwweekm
asbxh	uwfudwwsthegxadwwfekm
ascle	uweggwwtheegwmgwwgshm
ascxh	uweudwwtthegwadwwgekm
asdxh	uwdudwwuthegvadwwhekm
asexh	uwcudwwvtheguadwwiekm
asfqg	uwbbewwwmgegthewwjxjm
asfxh	uwbudwwwthegtadwwjekm
asgxh	uwaudwwxthegsadwwkekm
ashxh	uwzudwwythegradwwlekm
asixh	uwyudwwzthegqadwwmekm
asjxh	uwxudwwathegpadwwnekm
askxh	uwwudwwbthegoadwwoekm
aslxh	uwvudwwcthegnadwwpekm
asmxh	uwuudwwdthegmadwwqekm
asnkg	uwthewweggeglnewwrrjm
asnxh	uwtudwwethegladwwrekm
asoxh	uwsudwwfthegkadwwsekm
aspab	uwrrjwwgwbegjxjwwthem
aspxh	uwrudwwgthegjadwwtekm
asqxh	uwqudwwhthegiadwwuekm
asrxh	uwpudwwitheghadwwvekm
assxh	uwoudwwjtheggadwwwekm
astxh	uwnudwwkthegfadwwxekm
asuxh	uwmudwwlthegeadwwyekm
asvxh	uwludwwmthegdadwwzekm
aswxh	uwkudwwnthegcadwwaekm
asxxh	uwjudwwothegbadwwbekm
asyxh	uwiudwwpthegaadwwcekm
aszxh	uwhudwwqthegzadwwdekm
ataxh	uvgudwxrthefyadwxeekm
atbxh	uvfudwxsthefxadwxfekm
atcle	uveggwxtheefwmgwxgshm
atcxh	uveudwxtthefwadwxgekm
atdxh	uvdudwxuthefvadwxhekm
atexh	uvcudwxvthefuadwxiekm
atfqg	uvbbewxwmgefthewxjxjm
atfxh	uvbudwxwtheftadwxjekm
atgxh	uvaudwxxthefsadwxkekm
athxh	uvzudwxythefradwxlekm
atixh	uvyudwxzthefqadwxmekm
atjxh	uvxudwxathefpadwxnekm
atkxh	uvwudwxbthefoadwxoekm
atlxh	uvvudwxcthefnadwxpekm
atmxh	uvuudwxdthefmadwxqekm
atnkg	uvthewxeggeflnewxrrjm
atnxh	uvtudwxethefladwxrekm
atoxh	uvsudwxfthefkadwxsekm
atpab	uvrrjwxgwbefjxjwxthem
atpxh	uvrudwxgthefjadwxtekm
atqxh	uvqudwxhthefiadwxuekm
atrxh	uvpudwxithefhadwxvekm
atsxh	uvoudwxjthefgadwxwekm
attxh	uvnudwxktheffadwxxekm
atuxh	uvmudwxlthefeadwxyekm
atvxh	uvludwxmthefdadwxzekm
atwxh	uvkudwxnthefcadwxaekm
atxxh	uvjudwxothefbadwxbekm
atyxh	uviudwxpthefaadwxcekm
atzxh	uvhudwxqthefzadwxdekm
auaxh	uugudwyrtheeyadwyeekm
aubxh	uufudwystheexadwyfekm
aucle	uueggwytheeewmgwygshm
aucxh	uueudwyttheewadwygekm
audxh	uududwyutheevadwyhekm
auexh	uucudwyvtheeuadwyiekm
aufqg	uubbewywmgeethewyjxjm
aufxh	uubudwywtheetadwyjekm
augxh	uuaudwyxtheesadwykekm
auhxh	uuzudwyytheeradwylekm
auixh	uuyudwyztheeqadwymekm
aujxh	uuxudwyatheepadwynekm
aukxh	uuwudwybtheeoadwyoekm
aulxh	uuvudwyctheenadwypekm
aumxh	uuuudwydtheemadwyqekm
aunkg	uuthewyeggeelnewyrrjm
aunxh	uutudwyetheeladwyrekm
auoxh	uusudwyftheekadwysekm
aupab	uurrjwygwbeejxjwythem
aupxh	uurudwygtheejadwytekm
auqxh	uuqudwyhtheeiadwyuekm
aurxh	uupudwyitheehadwyvekm
ausxh	uuoudwyjtheegadwywekm
autxh	uunudwyktheefadwyxekm
auuxh	uumudwyltheeeadwyyekm
auvxh	uuludwymtheedadwyzekm
auwxh	uukudwyntheecadwyaekm
auxxh	uujudwyotheebadwybekm
auyxh	uuiudwyptheeaadwycekm
auzxh	uuhudwyqtheezadwydekm
avaxh	utgudwzrthedyadwzeekm
avbxh	utfudwzsthedxadwzfekm
avcle	uteggwztheedwmgwzgshm
avcxh	uteudwztthedwadwzgekm
avdxh	utdudwzuthedvadwzhekm
avexh	utcudwzvtheduadwziekm
avfqg	utbbewzwmgedthewzjxjm
avfxh	utbudwzwthedtadwzjekm
avgxh	utaudwzxthedsadwzkekm
avhxh	utzudwzythedradwzlekm
avixh	utyudwzzthedqadwzmekm
avjxh	utxudwzathedpadwznekm
avkxh	utwudwzbthedoadwzoekm
avlxh	utvudwzcthednadwzpekm
avmxh	utuudwzdthedmadwzqekm
avnkg	utthewzeggedlnewzrrjm
avnxh	uttudwzethedladwzrekm
avoxh	utsudwzfthedkadwzsekm
avpab	utrrjwzgwbedjxjwzthem
avpxh	utrudwzgthedjadwztekm
avqxh	utqudwzhthediadwzuekm
avrxh	utpudwzithedhadwzvekm
avsxh	utoudwzjthedgadwzwekm
avtxh	utnudwzkthedfadwzxekm
avuxh	utmudwzlthedeadwzyekm
avvxh	utludwzmtheddadwzzekm
avwxh	utkudwznthedcadwzaekm
avxxh	utjudwzothedbadwzbekm
avyxh	utiudwzpthedaadwzcekm
avzna	uthekwzqjaedzkkwzdudm
avzxh	uthudwzqthedzadwzdekm
awaxh	usgudwarthecyadwaeekm
awbxh	usfudwasthecxadwafekm
awcle	useggwatheecwmgwagshm
awcxh	useudwatthecwadwagekm
awdxh	usdudwauthecvadwahekm
awexh	uscudwavthecuadwaiekm
awfqg	usbbewawmgecthewajxjm
awfxh	usbudwawthectadwajekm
awgxh	usaudwaxthecsadwakekm
awhxh	uszudwaythecradwalekm
awixh	usyudwazthecqadwamekm
awjxh	usxudwaathecpadwanekm
awkxh	uswudwabthecoadwaoekm
awlxh	usvudwacthecnadwapekm
awmxh	usuudwadthecmadwaqekm
awnkg	usthewaeggeclnewarrjm
awnxh	ustudwaethecladwarekm
awoxh	ussudwaftheckadwasekm
awpab	usrrjwagwbecjxjwathem
awpxh	usrudwagthecjadwatekm
awqxh	usqudwahtheciadwauekm
awrxh	uspudwaithechadwavekm
awsxh	usoudwajthecgadwawekm
awtxh	usnudwakthecfadwaxekm
awuxh	usmudwaltheceadwayekm
awvxh	usludwamthecdadwazekm
awwxh	uskudwantheccadwaaekm
awxxh	usjudwaothecbadwabekm
awyxh	usiudwapthecaadwacekm
awzxh	ushudwaqtheczadwadekm
axaxh	urgudwbrthebyadwbeekm
axbxh	urfudwbsthebxadwbfekm
axcle	ureggwbtheebwmgwbgshm
axcxh	ureudwbtthebwadwbgekm
axdxh	urdudwbuthebvadwbhekm
axexh	urcudwbvthebuadwbiekm
axfqg	urbbewbwmgebthewbjxjm
axfxh	urbudwbwthebtadwbjekm
axgxh	uraudwbxthebsadwbkekm
axhxh	urzudwbythebradwblekm
axixh	uryudwbzthebqadwbmekm
axjxh	urxudwbathebpadwbnekm
axkxh	urwudwbbtheboadwboekm
axlxh	urvudwbcthebnadwbpekm
axmxh	uruudwbdthebmadwbqekm
axnkg	urthewbeggeblnewbrrjm
axnxh	urtudwbethebladwbrekm
axoxh	ursudwbfthebkadwbsekm
axpab	urrrjwbgwbebjxjwbthem
axpxh	urrudwbgthebjadwbtekm
axqxh	urqudwbhthebiadwbuekm
axrxh	urpudwbithebhadwbvekm
axsxh	uroudwbjthebgadwbwekm
axtxh	urnudwbkthebfadwbxekm
axuxh	urmudwblthebeadwbyekm
axvxh	urludwbmthebdadwbzekm
axwxh	urkudwbnthebcadwbaekm
axxxh	urjudwbothebbadwbbekm
axyxh	uriudwbpthebaadwbcekm
axzxh	urhudwbqthebzadwbdekm
ayaxh	uqgudwcrtheayadwceekm
aybxh	uqfudwcstheaxadwcfekm
aycle	uqeggwctheeawmgwcgshm
aycxh	uqeudwcttheawadwcgekm
aydxh	uqdudwcutheavadwchekm
ayexh	uqcudwcvtheauadwciekm
ayfqg	uqbbewcwmgeathewcjxjm
ayfxh	uqbudwcwtheatadwcjekm
aygxh	uqaudwcxtheasadwckekm
ayhxh	uqzudwcythearadwclekm
ayixh	uqyudwcztheaqadwcmekm
ayjxh	uqxudwcatheapadwcnekm
aykxh	uqwudwcbtheaoadwcoekm
aylxh	uqvudwcctheanadwcpekm
aymxh	uquudwcdtheamadwcqekm
aynkg	uqthewceggealnewcrrjm
aynxh	uqtudwcethealadwcrekm
ayoxh	uqsudwcftheakadwcsekm
aypab	uqrrjwcgwbeajxjwcthem
aypxh	uqrudwcgtheajadwctekm
ayqxh	uqqudwchtheaiadwcuekm
ayrxh	uqpudwcitheahadwcvekm
aysxh	uqoudwcjtheagadwcwekm
aytxh	uqnudwcktheafadwcxekm
ayuxh	uqmudwcltheaeadwcyekm
ayvxh	uqludwcmtheadadwczekm
aywxh	uqkudwcntheacadwcaekm
ayxxh	uqjudwcotheabadwcbekm
ayyxh	uqiudwcptheaaadwccekm
ayzxh	uqhudwcqtheazadwcdekm
azaxh	upgudwdrthezyadwdeekm
azbxh	upfudwdsthezxadwdfekm
azcle	upeggwdtheezwmgwdgshm
azcxh	upeudwdtthezwadwdgekm
azdxh	updudwduthezvadwdhekm
azexh	upcudwdvthezuadwdiekm
azfqg	upbbewdwmgezthewdjxjm
azfxh	upbudwdwtheztadwdjekm
azgxh	upaudwdxthezsadwdkekm
azhxh	upzudwdythezradwdlekm
azixh	upyudwdzthezqadwdmekm
azjxh	upxudwdathezpadwdnekm
azkxh	upwudwdbthezoadwdoekm
azlxh	upvudwdctheznadwdpekm
azmxh	upuudwddthezmadwdqekm
aznkg	upthewdeggezlnewdrrjm
aznxh	uptudwdethezladwdrekm
azoxh	upsudwdfthezkadwdsekm
azpab	uprrjwdgwbezjxjwdthem
azpxh	uprudwdgthezjadwdtekm
azqxh	upqudwdhtheziadwduekm
azrxh	uppudwdithezhadwdvekm
azsxh	upoudwdjthezgadwdwekm
aztxh	upnudwdkthezfadwdxekm
azuxh	upmudwdlthezeadwdyekm
azvxh	upludwdmthezdadwdzekm
azwxh	upkudwdnthezcadwdaekm
azxxh	upjudwdothezbadwdbekm
azyxh	upiudwdpthezaadwdcekm
azzxh	uphudwdqthezzadwddekm
bacle	toeggxethedywmgxegshl
bafqg	tobbexewmgdythexejxjl
bankg	tothexeeggdylnexerrjl
bapab	torrjxegwbdyjxjxethel
bbcle	tneggxfthedxwmgxfgshl
bbfqg	tnbbexfwmgdxthexfjxjl
bbnkg	tnthexfeggdxlnexfrrjl
bbpab	tnrrjxfgwbdxjxjxfthel
bccle	tmeggxgthedwwmgxggshl
bcfqg	tmbbexgwmgdwthexgjxjl
bcnkg	tmthexgeggdwlnexgrrjl
bcpab	tmrrjxggwbdwjxjxgthel
bdcle	tleggxhthedvwmgxhgshl
bdfqg	tlbbexhwmgdvthexhjxjl
bdnkg	tlthexheggdvlnexhrrjl
bdpab	tlrrjxhgwbdvjxjxhthel
becle	tkeggxitheduwmgxigshl
befqg	tkbbexiwmgduthexijxjl
benkg	tkthexieggdulnexirrjl
bepab	tkrrjxigwbdujxjxithel
bfcle	tjeggxjthedtwmgxjgshl
bffqg	tjbbexjwmgdtthexjjxjl
bfnkg	tjthexjeggdtlnexjrrjl
bfpab	tjrrjxjgwbdtjxjxjthel
bfrta	tjpykxjipadthekxjvadl
bgcle	tieggxkthedswmgxkgshl
bgfqg	tibbexkwmgdsthexkjxjl
bgnkg	tithexkeggdslnexkrrjl
bgpab	tirrjxkgwbdsjxjxkthel
bhcaa	therkxltwadrwxkxlghdl
bhcba	theqkxltxadrwwkxlgidl
bhcca	thepkxltyadrwvkxlgjdl
bhcda	theokxltzadrwukxlgkdl
bhcea	thenkxltaadrwtkxlgldl
bhcfa	themkxltbadrwskxlgmdl
bhcga	thelkxltcadrwrkxlgndl
bhcha	thekkxltdadrwqkxlgodl
bhcia	thejkxlteadrwpkxlgpdl
bhcja	theikxltfadrwokxlgqdl
bhcka	thehkxltgadrwnkxlgrdl
bhcla	thegkxlthadrwmkxlgsdl
bhcma	thefkxltiadrwlkxlgtdl
bhcna	theekxltjadrwkkxlgudl
bhcoa	thedkxltkadrwjkxlgvdl
bhcpa	theckxltladrwikxlgwdl
bhcqa	thebkxltmadrwhkxlgxdl
bhcra	theakxltnadrwgkxlgydl
bhcsa	thezkxltoadrwfkxlgzdl
bhcta	theykxltpadrwekxlgadl
bhcua	thexkxltqadrwdkxlgbdl
bhcva	thewkxltradrwckxlgcdl
bhcwa	thevkxltsadrwbkxlgddl
bhcxa	theukxlttadrwakxlgedl
bhcya	thetkxltuadrwzkxlgfdl
bhcza	theskxltvadrwykxlggdl
bhfqg	thbbexlwmgdrthexljxjl
bhnkg	ththexleggdrlnexlrrjl
bhpab	thrrjxlgwbdrjxjxlthel
bicle	tgeggxmthedqwmgxmgshl
bifqg	tgbbexmwmgdqthexmjxjl
binkg	tgthexmeggdqlnexmrrjl
bipab	tgrrjxmgwbdqjxjxmthel
bjcle	tfeggxnthedpwmgxngshl
bjfqg	tfbbexnwmgdpthexnjxjl
bjnkg	tfthexneggdplnexnrrjl
bjpab	tfrrjxngwbdpjxjxnthel
bkcle	teeggxothedowmgxogshl
bkfqg	tebbexowmgdothexojxjl
bknkg	tethexoeggdolnexorrjl
bkpab	terrjxogwbdojxjxothel
blcle	tdeggxpthednwmgxpgshl
blfqg	tdbbexpwmgdnthexpjxjl
blnkg	tdthexpeggdnlnexprrjl
blpab	tdrrjxpgwbdnjxjxpthel
bmcle	tceggxqthedmwmgxqgshl
bmfqg	tcbbexqwmgdmthexqjxjl
bmnkg	tcthexqeggdmlnexqrrjl
bmpab	tcrrjxqgwbdmjxjxqthel
bncle	tbeggxrthedlwmgxrgshl
bnfqg	tbbbexrwmgdlthexrjxjl
bnnkg	tbthexreggdllnexrrrjl
bnpab	tbrrjxrgwbdljxjxrthel
bocle	taeggxsthedkwmgxsgshl
bofqg	tabbexswmgdkthexsjxjl
bonkg	tathexseggdklnexsrrjl
bopab	tarrjxsgwbdkjxjxsthel
bpcle	tzeggxtthedjwmgxtgshl
bpdxa	tzdukxtutadjvakxthedl
bpfqg	tzbbextwmgdjthextjxjl
bpnkg	tzthexteggdjlnextrrjl
bppab	tzrrjxtgwbdjjxjxtthel
bpqia	tzqjkxtheadjipkxtupdl
bqcle	tyeggxuthediwmgxugshl
bqfqg	tybbexuwmgdithexujxjl
bqnkg	tythexueggdilnexurrjl
bqpab	tyrrjxugwbdijxjxuthel
brcle	txeggxvthedhwmgxvgshl
brfqg	txbbexvwmgdhthexvjxjl
brnkg	txthexveggdhlnexvrrjl
brpab	txrrjxvgwbdhjxjxvthel
bscle	tweggxwthedgwmgxwgshl
bsfqg	twbbexwwmgdgthexwjxjl
bsnkg	twthexweggdglnexwrrjl
bspab	twrrjxwgwbdgjxjxwthel
btcle	tveggxxthedfwmgxxgshl
btfqg	tvbbexxwmgdfthexxjxjl
btnkg	tvthexxeggdflnexxrrjl
btpab	tvrrjxxgwbdfjxjxxthel
bucle	tueggxythedewmgxygshl
bufqg	tubbexywmgdethexyjxjl
bunkg	tuthexyeggdelnexyrrjl
bupab	turrjxygwbdejxjxythel
bvcle	tteggxztheddwmgxzgshl
bvfqg	ttbbexzwmgddthexzjxjl
bvnkg	ttthexzeggddlnexzrrjl
bvpab	ttrrjxzgwbddjxjxzthel
bvzna	tthekxzqjaddzkkxzdudl
bwcle	tseggxathedcwmgxagshl
bwfqg	tsbbexawmgdcthexajxjl
bwnkg	tsthexaeggdclnexarrjl
bwpab	tsrrjxagwbdcjxjxathel
bxcle	treggxbthedbwmgxbgshl
bxfqg	trbbexbwmgdbthexbjxjl
bxnkg	trthexbeggdblnexbrrjl
bxpab	trrrjxbgwbdbjxjxbthel
bycle	tqeggxcthedawmgxcgshl
byfqg	tqbbexcwmgdathexcjxjl
bynkg	tqthexceggdalnexcrrjl
bypab	tqrrjxcgwbdajxjxcthel
bzcle	tpeggxdthedzwmgxdgshl
bzfqg	tpbbexdwmgdzthexdjxjl
bznkg	tpthexdeggdzlnexdrrjl
bzpab	tprrjxdgwbdzjxjxdthel
cacle	soeggyethecywmgyegshk
cafqg	sobbeyewmgcytheyejxjk
cankg	sotheyeeggcylneyerrjk
capab	sorrjyegwbcyjxjyethek
cbcle	sneggyfthecxwmgyfgshk
cbfqg	snbbeyfwmgcxtheyfjxjk
cbnkg	sntheyfeggcxlneyfrrjk
cbpab	snrrjyfgwbcxjxjyfthek
cccle	smeggygthecwwmgyggshk
ccfqg	smbbeygwmgcwtheygjxjk
ccnkg	smtheygeggcwlneygrrjk
ccpab	smrrjyggwbcwjxjygthek
cdcle	sleggyhthecvwmgyhgshk
cdfqg	slbbeyhwmgcvtheyhjxjk
cdnkg	sltheyheggcvlneyhrrjk
cdpab	slrrjyhgwbcvjxjyhthek
cecle	skeggyithecuwmgyigshk
cefqg	skbbeyiwmgcutheyijxjk
cenkg	sktheyieggculneyirrjk
cepab	skrrjyigwbcujxjyithek
cfcle	sjeggyjthectwmgyjgshk
cffqg	sjbbeyjwmgcttheyjjxjk
cfnkg	sjtheyjeggctlneyjrrjk
cfpab	sjrrjyjgwbctjxjyjthek
cfrta	sjpykyjipacthekyjvadk
cgcle	sieggykthecswmgykgshk
cgfqg	sibbeykwmgcstheykjxjk
cgnkg	sitheykeggcslneykrrjk
cgpab	sirrjykgwbcsjxjykthek
chcle	sheggylthecrwmgylgshk
chfqg	shbbeylwmgcrtheyljxjk
chnkg	shtheyleggcrlneylrrjk
chpab	shrrjylgwbcrjxjylthek
cicle	sgeggymthecqwmgymgshk
cifqg	sgbbeymwmgcqtheymjxjk
cinkg	sgtheymeggcqlneymrrjk
cipab	sgrrjymgwbcqjxjymthek
cjcle	sfeggynthecpwmgyngshk
cjfqg	sfbbeynwmgcptheynjxjk
cjnkg	sftheyneggcplneynrrjk
cjpab	sfrrjyngwbcpjxjynthek
ckcle	seeggyothecowmgyogshk
ckfqg	sebbeyowmgcotheyojxjk
cknkg	setheyoeggcolneyorrjk
ckpab	serrjyogwbcojxjyothek
clcle	sdeggypthecnwmgypgshk
clfqg	sdbbeypwmgcntheypjxjk
clnkg	sdtheypeggcnlneyprrjk
clpab	sdrrjypgwbcnjxjypthek
cmcle	sceggyqthecmwmgyqgshk
cmfqg	scbbeyqwmgcmtheyqjxjk
cmnkg	sctheyqeggcmlneyqrrjk
cmpab	scrrjyqgwbcmjxjyqthek
cncle	sbeggyrtheclwmgyrgshk
cnfqg	sbbbeyrwmgcltheyrjxjk
cnnkg	sbtheyreggcllneyrrrjk
cnpab	sbrrjyrgwbcljxjyrthek
cocle	saeggystheckwmgysgshk
cofqg	sabbeyswmgcktheysjxjk
conkg	satheyseggcklneysrrjk
copab	sarrjysgwbckjxjysthek
cpcle	szeggytthecjwmgytgshk
cpdxa	szdukytutacjvakythedk
cpfqg	szbbeytwmgcjtheytjxjk
cpnkg	sztheyteggcjlneytrrjk
cppab	szrrjytgwbcjjxjytthek
cpqia	szqjkytheacjipkytupdk
cqcle	syeggyutheciwmgyugshk
cqfqg	sybbeyuwmgcitheyujxjk
cqnkg	sytheyueggcilneyurrjk
cqpab	syrrjyugwbcijxjyuthek
crcle	sxeggyvthechwmgyvgshk
crfqg	sxbbeyvwmgchtheyvjxjk
crnkg	sxtheyveggchlneyvrrjk
crpab	sxrrjyvgwbchjxjyvthek
cscle	sweggywthecgwmgywgshk
csfqg	swbbeywwmgcgtheywjxjk
csnkg	swtheyweggcglneywrrjk
cspab	swrrjywgwbcgjxjywthek
ctcle	sveggyxthecfwmgyxgshk
ctfqg	svbbeyxwmgcftheyxjxjk
ctnkg	svtheyxeggcflneyxrrjk
ctpab	svrrjyxgwbcfjxjyxthek
cucle	sueggyythecewmgyygshk
cufqg	subbeyywmgcetheyyjxjk
cunkg	sutheyyeggcelneyyrrjk
cupab	surrjyygwbcejxjyythek
cvcle	steggyzthecdwmgyzgshk
cvfqg	stbbeyzwmgcdtheyzjxjk
cvnkg	sttheyzeggcdlneyzrrjk
cvpab	strrjyzgwbcdjxjyzthek
cvzna	sthekyzqjacdzkkyzdudk
cwcle	sseggyatheccwmgyagshk
cwfqg	ssbbeyawmgcctheyajxjk
cwnkg	sstheyaeggcclneyarrjk
cwpab	ssrrjyagwbccjxjyathek
cxcle	sreggybthecbwmgybgshk
cxfqg	srbbeybwmgcbtheybjxjk
cxnkg	srtheybeggcblneybrrjk
cxpab	srrrjybgwbcbjxjybthek
cycle	sqeggycthecawmgycgshk
cyfqg	sqbbeycwmgcatheycjxjk
cynkg	sqtheyceggcalneycrrjk
cypab	sqrrjycgwbcajxjycthek
czcle	speggydtheczwmgydgshk
czfqg	spbbeydwmgcztheydjxjk
cznkg	sptheydeggczlneydrrjk
czpab	sprrjydgwbczjxjydthek
dacle	roeggzethebywmgzegshj
dafqg	robbezewmgbythezejxjj
dankg	rothezeeggbylnezerrjj
dapab	rorrjzegwbbyjxjzethej
dbcle	rneggzfthebxwmgzfgshj
dbfqg	rnbbezfwmgbxthezfjxjj
dbnkg	rnthezfeggbxlnezfrrjj
dbpab	rnrrjzfgwbbxjxjzfthej
dccle	rmeggzgthebwwmgzggshj
dcfqg	rmbbezgwmgbwthezgjxjj
dcnkg	rmthezgeggbwlnezgrrjj
dcpab	rmrrjzggwbbwjxjzgthej
ddcle	rleggzhthebvwmgzhgshj
ddfqg	rlbbezhwmgbvthezhjxjj
ddnkg	rlthezheggbvlnezhrrjj
ddpab	rlrrjzhgwbbvjxjzhthej
decle	rkeggzithebuwmgzigshj
defqg	rkbbeziwmgbuthezijxjj
denkg	rkthezieggbulnezirrjj
depab	rkrrjzigwbbujxjzithej
dfcle	rjeggzjthebtwmgzjgshj
dffqg	rjbbezjwmgbtthezjjxjj
dfnkg	rjthezjeggbtlnezjrrjj
dfpab	rjrrjzjgwbbtjxjzjthej
dfrta	rjpykzjipabthekzjvadj
dgcle	rieggzkthebswmgzkgshj
dgfqg	ribbezkwmgbsthezkjxjj
dgnkg	rithezkeggbslnezkrrjj
dgpab	rirrjzkgwbbsjxjzkthej
dhcle	rheggzlthebrwmgzlgshj
dhfqg	rhbbezlwmgbrthezljxjj
dhnkg	rhthezleggbrlnezlrrjj
dhpab	rhrrjzlgwbbrjxjzlthej
dicle	rgeggzmthebqwmgzmgshj
difqg	rgbbezmwmgbqthezmjxjj
dinkg	rgthezmeggbqlnezmrrjj
dipab	rgrrjzmgwbbqjxjzmthej
djcle	rfeggznthebpwmgzngshj
djfqg	rfbbeznwmgbptheznjxjj
djnkg	rfthezneggbplneznrrjj
djpab	rfrrjzngwbbpjxjznthej
dkcle	reeggzothebowmgzogshj
dkfqg	rebbezowmgbothezojxjj
dknkg	rethezoeggbolnezorrjj
dkpab	rerrjzogwbbojxjzothej
dlcle	rdeggzpthebnwmgzpgshj
dlfqg	rdbbezpwmgbnthezpjxjj
dlnkg	rdthezpeggbnlnezprrjj
dlpab	rdrrjzpgwbbnjxjzpthej
dmcle	rceggzqthebmwmgzqgshj
dmfqg	rcbbezqwmgbmthezqjxjj
dmnkg	rcthezqeggbmlnezqrrjj
dmpab	rcrrjzqgwbbmjxjzqthej
dncle	rbeggzrtheblwmgzrgshj
dnfqg	rbbbezrwmgblthezrjxjj
dnnkg	rbthezreggbllnezrrrjj
dnpab	rbrrjzrgwbbljxjzrthej
docle	raeggzsthebkwmgzsgshj
dofqg	rabbezswmgbkthezsjxjj
donkg	rathezseggbklnezsrrjj
dopab	rarrjzsgwbbkjxjzsthej
dpcle	rzeggztthebjwmgztgshj
dpdxa	rzdukztutabjvakzthedj
dpfqg	rzbbeztwmgbjtheztjxjj
dpnkg	rzthezteggbjlneztrrjj
dppab	rzrrjztgwbbjjxjztthej
dpqia	rzqjkztheabjipkztupdj
dqcle	ryeggzuthebiwmgzugshj
dqfqg	rybbezuwmgbithezujxjj
dqnkg	rythezueggbilnezurrjj
dqpab	ryrrjzugwbbijxjzuthej
drcle	rxeggzvthebhwmgzvgshj
drfqg	rxbbezvwmgbhthezvjxjj
drnkg	rxthezveggbhlnezvrrjj
drpab	rxrrjzvgwbbhjxjzvthej
dscle	rweggzwthebgwmgzwgshj
dsfqg	rwbbezwwmgbgthezwjxjj
dsnkg	rwthezweggbglnezwrrjj
dspab	rwrrjzwgwbbgjxjzwthej
dtcle	rveggzxthebfwmgzxgshj
dtfqg	rvbbezxwmgbfthezxjxjj
dtnkg	rvthezxeggbflnezxrrjj
dtpab	rvrrjzxgwbbfjxjzxthej
ducle	rueggzythebewmgzygshj
dufqg	rubbezywmgbethezyjxjj
dunkg	ruthezyeggbelnezyrrjj
dupab	rurrjzygwbbejxjzythej
dvcle	rteggzzthebdwmgzzgshj
dvfqg	rtbbezzwmgbdthezzjxjj
dvnkg	rtthezzeggbdlnezzrrjj
dvpab	rtrrjzzgwbbdjxjzzthej
dvzna	rthekzzqjabdzkkzzdudj
dwcle	rseggzathebcwmgzagshj
dwfqg	rsbbezawmgbcthezajxjj
dwnkg	rsthezaeggbclnezarrjj
dwpab	rsrrjzagwbbcjxjzathej
dxcle	rreggzbthebbwmgzbgshj
dxfqg	rrbbezbwmgbbthezbjxjj
dxnkg	rrthezbeggbblnezbrrjj
dxpab	rrrrjzbgwbbbjxjzbthej
dycle	rqeggzcthebawmgzcgshj
dyfqg	rqbbezcwmgbathezcjxjj
dynkg	rqthezceggbalnezcrrjj
dypab	rqrrjzcgwbbajxjzcthej
dzcle	rpeggzdthebzwmgzdgshj
dzfqg	rpbbezdwmgbzthezdjxjj
dznkg	rpthezdeggbzlnezdrrjj
dzpab	rprrjzdgwbbzjxjzdthej
eacle	qoeggaetheaywmgaegshi
eafqg	qobbeaewmgaytheaejxji
eankg	qotheaeeggaylneaerrji
eapab	qorrjaegwbayjxjaethei
ebcle	qneggaftheaxwmgafgshi
ebfqg	qnbbeafwmgaxtheafjxji
ebnkg	qntheafeggaxlneafrrji
ebpab	qnrrjafgwbaxjxjafthei
eccle	qmeggagtheawwmgaggshi
ecfqg	qmbbeagwmgawtheagjxji
ecnkg	qmtheageggawlneagrrji
ecpab	qmrrjaggwbawjxjagthei
edcle	qleggahtheavwmgahgshi
edfqg	qlbbeahwmgavtheahjxji
ednkg	qltheaheggavlneahrrji
edpab	qlrrjahgwbavjxjahthei
eecle	qkeggaitheauwmgaigshi
eefqg	qkbbeaiwmgautheaijxji
eenkg	qktheaieggaulneairrji
eepab	qkrrjaigwbaujxjaithei
efcle	qjeggajtheatwmgajgshi
effqg	qjbbeajwmgattheajjxji
efnkg	qjtheajeggatlneajrrji
efpab	qjrrjajgwbatjxjajthei
efrta	qjpykajipaathekajvadi
egcle	qieggaktheaswmgakgshi
egfqg	qibbeakwmgastheakjxji
egnkg	qitheakeggaslneakrrji
egpab	qirrjakgwbasjxjakthei
ehcle	qheggalthearwmgalgshi
ehfqg	qhbbealwmgarthealjxji
ehnkg	qhthealeggarlnealrrji
ehpab	qhrrjalgwbarjxjalthei
eicle	qgeggamtheaqwmgamgshi
eifqg	qgbbeamwmgaqtheamjxji
einkg	qgtheameggaqlneamrrji
eipab	qgrrjamgwbaqjxjamthei
ejcle	qfeggantheapwmgangshi
ejfqg	qfbbeanwmgaptheanjxji
ejnkg	qftheaneggaplneanrrji
ejpab	qfrrjangwbapjxjanthei
ekcle	qeeggaotheaowmgaogshi
ekfqg	qebbeaowmgaotheaojxji
eknkg	qetheaoeggaolneaorrji
ekpab	qerrjaogwbaojxjaothei
elcle	qdeggaptheanwmgapgshi
elfqg	qdbbeapwmgantheapjxji
elnkg	qdtheapegganlneaprrji
elpab	qdrrjapgwbanjxjapthei
emcle	qceggaqtheamwmgaqgshi
emfqg	qcbbeaqwmgamtheaqjxji
emnkg	qctheaqeggamlneaqrrji
empab	qcrrjaqgwbamjxjaqthei
encle	qbeggarthealwmgargshi
enfqg	qbbbearwmgalthearjxji
ennkg	qbtheareggallnearrrji
enpab	qbrrjargwbaljxjarthei
eocle	qaeggastheakwmgasgshi
eofqg	qabbeaswmgaktheasjxji
eonkg	qatheaseggaklneasrrji
eopab	qarrjasgwbakjxjasthei
epcle	qzeggattheajwmgatgshi
epdxa	qzdukatutaajvakathedi
epfqg	qzbbeatwmgajtheatjxji
epnkg	qztheateggajlneatrrji
eppab	qzrrjatgwbajjxjatthei
epqia	qzqjkatheaajipkatupdi
eqcle	qyeggautheaiwmgaugshi
eqfqg	qybbeauwmgaitheaujxji
eqnkg	qytheaueggailneaurrji
eqpab	qyrrjaugwbaijxjauthei
ercle	qxeggavtheahwmgavgshi
erfqg	qxbbeavwmgahtheavjxji
ernkg	qxtheaveggahlneavrrji
erpab	qxrrjavgwbahjxjavthei
escle	qweggawtheagwmgawgshi
esfqg	qwbbeawwmgagtheawjxji
esnkg	qwtheaweggaglneawrrji
espab	qwrrjawgwbagjxjawthei
etcle	qveggaxtheafwmgaxgshi
etfqg	qvbbeaxwmgaftheaxjxji
etnkg	qvtheaxeggaflneaxrrji
etpab	qvrrjaxgwbafjxjaxthei
eucle	queggaytheaewmgaygshi
eufqg	qubbeaywmgaetheayjxji
eunkg	qutheayeggaelneayrrji
eupab	qurrjaygwbaejxjaythei
evcle	qteggaztheadwmgazgshi
evfqg	qtbbeazwmgadtheazjxji
evnkg	qttheazeggadlneazrrji
evpab	qtrrjazgwbadjxjazthei
evzna	qthekazqjaadzkkazdudi
ewcle	qseggaatheacwmgaagshi
ewfqg	qsbbeaawmgactheaajxji
ewnkg	qstheaaeggaclneaarrji
ewpab	qsrrjaagwbacjxjaathei
excle	qreggabtheabwmgabgshi
exfqg	qrbbeabwmgabtheabjxji
exnkg	qrtheabeggablneabrrji
expab	qrrrjabgwbabjxjabthei
eycle	qqeggactheaawmgacgshi
eyfqg	qqbbeacwmgaatheacjxji
eynkg	qqtheaceggaalneacrrji
eypab	qqrrjacgwbaajxjacthei
ezcle	qpeggadtheazwmgadgshi
ezfqg	qpbbeadwmgaztheadjxji
eznkg	qptheadeggazlneadrrji
ezpab	qprrjadgwbazjxjadthei
facle	poeggbethezywmgbegshh
fafqg	pobbebewmgzythebejxjh
fankg	pothebeeggzylneberrjh
fapab	porrjbegwbzyjxjbetheh
fbcle	pneggbfthezxwmgbfgshh
fbfqg	pnbbebfwmgzxthebfjxjh
fbnkg	pnthebfeggzxlnebfrrjh
fbpab	pnrrjbfgwbzxjxjbftheh
fccle	pmeggbgthezwwmgbggshh
fcfqg	pmbbebgwmgzwthebgjxjh
fcnkg	pmthebgeggzwlnebgrrjh
fcpab	pmrrjbggwbzwjxjbgtheh
fdcle	pleggbhthezvwmgbhgshh
fdfqg	plbbebhwmgzvthebhjxjh
fdnkg	plthebheggzvlnebhrrjh
fdpab	plrrjbhgwbzvjxjbhtheh
fecle	pkeggbithezuwmgbigshh
fefqg	pkbbebiwmgzuthebijxjh
fenkg	pkthebieggzulnebirrjh
fepab	pkrrjbigwbzujxjbitheh
ffcle	pjeggbjtheztwmgbjgshh
fffqg	pjbbebjwmgztthebjjxjh
ffnkg	pjthebjeggztlnebjrrjh
ffpab	pjrrjbjgwbztjxjbjtheh
ffrta	pjpykbjipazthekbjvadh
fgcle	pieggbkthezswmgbkgshh
fgfqg	pibbebkwmgzsthebkjxjh
fgnkg	pithebkeggzslnebkrrjh
fgpab	pirrjbkgwbzsjxjbktheh
fhcle	pheggblthezrwmgblgshh
fhfqg	phbbeblwmgzrthebljxjh
fhnkg	phthebleggzrlneblrrjh
fhpab	phrrjblgwbzrjxjbltheh
ficle	pgeggbmthezqwmgbmgshh
fifqg	pgbbebmwmgzqthebmjxjh
finkg	pgthebmeggzqlnebmrrjh
fipab	pgrrjbmgwbzqjxjbmtheh
fjcle	pfeggbnthezpwmgbngshh
fjfqg	pfbbebnwmgzpthebnjxjh
fjnkg	pfthebneggzplnebnrrjh
fjpab	pfrrjbngwbzpjxjbntheh
fkcle	peeggbothezowmgbogshh
fkfqg	pebbebowmgzothebojxjh
fknkg	petheboeggzolneborrjh
fkpab	perrjbogwbzojxjbotheh
flcle	pdeggbptheznwmgbpgshh
flfqg	pdbbebpwmgznthebpjxjh
flnkg	pdthebpeggznlnebprrjh
flpab	pdrrjbpgwbznjxjbptheh
fmcle	pceggbqthezmwmgbqgshh
fmfqg	pcbbebqwmgzmthebqjxjh
fmnkg	pcthebqeggzmlnebqrrjh
fmpab	pcrrjbqgwbzmjxjbqtheh
fncle	pbeggbrthezlwmgbrgshh
fnfqg	pbbbebrwmgzlthebrjxjh
fnnkg	pbthebreggzllnebrrrjh
fnpab	pbrrjbrgwbzljxjbrtheh
focle	paeggbsthezkwmgbsgshh
fofqg	pabbebswmgzkthebsjxjh
fonkg	pathebseggzklnebsrrjh
fopab	parrjbsgwbzkjxjbstheh
fpcle	pzeggbtthezjwmgbtgshh
fpdxa	pzdukbtutazjvakbthedh
fpfqg	pzbbebtwmgzjthebtjxjh
fpnkg	pzthebteggzjlnebtrrjh
fppab	pzrrjbtgwbzjjxjbttheh
fpqia	pzqjkbtheazjipkbtupdh
fqcle	pyeggbutheziwmgbugshh
fqfqg	pybbebuwmgzithebujxjh
fqnkg	pythebueggzilneburrjh
fqpab	pyrrjbugwbzijxjbutheh
frcle	pxeggbvthezhwmgbvgshh
frfqg	pxbbebvwmgzhthebvjxjh
frnkg	pxthebveggzhlnebvrrjh
frpab	pxrrjbvgwbzhjxjbvtheh
fscle	pweggbwthezgwmgbwgshh
fsfqg	pwbbebwwmgzgthebwjxjh
fsnkg	pwthebweggzglnebwrrjh
fspab	pwrrjbwgwbzgjxjbwtheh
ftcle	pveggbxthezfwmgbxgshh
ftfqg	pvbbebxwmgzfthebxjxjh
ftnkg	pvthebxeggzflnebxrrjh
ftpab	pvrrjbxgwbzfjxjbxtheh
fucle	pueggbythezewmgbygshh
fufqg	pubbebywmgzethebyjxjh
funkg	puthebyeggzelnebyrrjh
fupab	purrjbygwbzejxjbytheh
fvcle	pteggbzthezdwmgbzgshh
fvfqg	ptbbebzwmgzdthebzjxjh
fvnkg	ptthebzeggzdlnebzrrjh
fvpab	ptrrjbzgwbzdjxjbztheh
fvzna	pthekbzqjazdzkkbzdudh
fwcle	pseggbathezcwmgbagshh
fwfqg	psbbebawmgzcthebajxjh
fwnkg	psthebaeggzclnebarrjh
fwpab	psrrjbagwbzcjxjbatheh
fxcle	preggbbthezbwmgbbgshh
fxfqg	prbbebbwmgzbthebbjxjh
fxnkg	prthebbeggzblnebbrrjh
fxpab	prrrjbbgwbzbjxjbbtheh
fycle	pqeggbcthezawmgbcgshh
fyfqg	pqbbebcwmgzathebcjxjh
fynkg	pqthebceggzalnebcrrjh
fypab	pqrrjbcgwbzajxjbctheh
fzcle	ppeggbdthezzwmgbdgshh
fzfqg	ppbbebdwmgzzthebdjxjh
fznkg	ppthebdeggzzlnebdrrjh
fzpab	pprrjbdgwbzzjxjbdtheh
gacle	ooeggcetheyywmgcegshg
gafqg	oobbecewmgyythecejxjg
gankg	ootheceeggyylnecerrjg
gapab	oorrjcegwbyyjxjcetheg
gbcle	oneggcftheyxwmgcfgshg
gbfqg	onbbecfwmgyxthecfjxjg
gbnkg	onthecfeggyxlnecfrrjg
gbpab	onrrjcfgwbyxjxjcftheg
gccle	omeggcgtheywwmgcggshg
gcfqg	ombbecgwmgywthecgjxjg
gcnkg	omthecgeggywlnecgrrjg
gcpab	omrrjcggwbywjxjcgtheg
gdcle	oleggchtheyvwmgchgshg
gdfqg	olbbechwmgyvthechjxjg
gdnkg	olthecheggyvlnechrrjg
gdpab	olrrjchgwbyvjxjchtheg
gecle	okeggcitheyuwmgcigshg
gefqg	okbbeciwmgyuthecijxjg
genkg	okthecieggyulnecirrjg
gepab	okrrjcigwbyujxjcitheg
gfcle	ojeggcjtheytwmgcjgshg
gffqg	ojbbecjwmgytthecjjxjg
gfnkg	ojthecjeggytlnecjrrjg
gfpab	ojrrjcjgwbytjxjcjtheg
gfrta	ojpykcjipaythekcjvadg
ggcle	oieggcktheyswmgckgshg
ggfqg	oibbeckwmgystheckjxjg
ggnkg	oitheckeggyslneckrrjg
ggpab	oirrjckgwbysjxjcktheg
ghcle	oheggcltheyrwmgclgshg
ghfqg	ohbbeclwmgyrthecljxjg
ghnkg	ohthecleggyrlneclrrjg
ghpab	ohrrjclgwbyrjxjcltheg
gicle	ogeggcmtheyqwmgcmgshg
gifqg	ogbbecmwmgyqthecmjxjg
ginkg	ogthecmeggyqlnecmrrjg
gipab	ogrrjcmgwbyqjxjcmtheg
gjcle	ofeggcntheypwmgcngshg
gjfqg	ofbbecnwmgypthecnjxjg
gjnkg	ofthecneggyplnecnrrjg
gjpab	ofrrjcngwbypjxjcntheg
gkcle	oeeggcotheyowmgcogshg
gkfqg	oebbecowmgyothecojxjg
gknkg	oethecoeggyolnecorrjg
gkpab	oerrjcogwbyojxjcotheg
glcle	odeggcptheynwmgcpgshg
glfqg	odbbecpwmgynthecpjxjg
glnkg	odthecpeggynlnecprrjg
glpab	odrrjcpgwbynjxjcptheg
gmcle	oceggcqtheymwmgcqgshg
gmfqg	ocbbecqwmgymthecqjxjg
gmnkg	octhecqeggymlnecqrrjg
gmpab	ocrrjcqgwbymjxjcqtheg
gncle	obeggcrtheylwmgcrgshg
gnfqg	obbbecrwmgylthecrjxjg
gnnkg	obthecreggyllnecrrrjg
gnpab	obrrjcrgwbyljxjcrtheg
gocle	oaeggcstheykwmgcsgshg
gofqg	oabbecswmgykthecsjxjg
gonkg	oathecseggyklnecsrrjg
gopab	oarrjcsgwbykjxjcstheg
gpcle	ozeggcttheyjwmgctgshg
gpdxa	ozdukctutayjvakcthedg
gpfqg	ozbbectwmgyjthectjxjg
gpnkg	ozthecteggyjlnectrrjg
gppab	ozrrjctgwbyjjxjcttheg
gpqia	ozqjkctheayjipkctupdg
gqcle	oyeggcutheyiwmgcugshg
gqfqg	oybbecuwmgyithecujxjg
gqnkg	oythecueggyilnecurrjg
gqpab	oyrrjcugwbyijxjcutheg
grcle	oxeggcvtheyhwmgcvgshg
grfqg	oxbbecvwmgyhthecvjxjg
grnkg	oxthecveggyhlnecvrrjg
grpab	oxrrjcvgwbyhjxjcvtheg
gscle	oweggcwtheygwmgcwgshg
gsfqg	owbbecwwmgygthecwjxjg
gsnkg	owthecweggyglnecwrrjg
gspab	owrrjcwgwbygjxjcwtheg
gtcle	oveggcxtheyfwmgcxgshg
gtfqg	ovbbecxwmgyfthecxjxjg
gtnkg	ovthecxeggyflnecxrrjg
gtpab	ovrrjcxgwbyfjxjcxtheg
gucle	oueggcytheyewmgcygshg
gufqg	oubbecywmgyethecyjxjg
gunkg	outhecyeggyelnecyrrjg
gupab	ourrjcygwbyejxjcytheg
gvcle	oteggcztheydwmgczgshg
gvfqg	otbbeczwmgydtheczjxjg
gvnkg	ottheczeggydlneczrrjg
gvpab	otrrjczgwbydjxjcztheg
gvzna	othekczqjaydzkkczdudg
gwcle	oseggcatheycwmgcagshg
gwfqg	osbbecawmgycthecajxjg
gwnkg	osthecaeggyclnecarrjg
gwpab	osrrjcagwbycjxjcatheg
gxcle	oreggcbtheybwmgcbgshg
gxfqg	orbbecbwmgybthecbjxjg
gxnkg	orthecbeggyblnecbrrjg
gxpab	orrrjcbgwbybjxjcbtheg
gycle	oqeggcctheyawmgccgshg
gyfqg	oqbbeccwmgyatheccjxjg
gynkg	oqthecceggyalneccrrjg
gypab	oqrrjccgwbyajxjcctheg
gzcle	opeggcdtheyzwmgcdgshg
gzfqg	opbbecdwmgyzthecdjxjg
gznkg	opthecdeggyzlnecdrrjg
gzpab	oprrjcdgwbyzjxjcdtheg
hacle	noeggdethexywmgdegshf
hafqg	nobbedewmgxythedejxjf
hankg	nothedeeggxylnederrjf
hapab	norrjdegwbxyjxjdethef
hbcle	nneggdfthexxwmgdfgshf
hbfqg	nnbbedfwmgxxthedfjxjf
hbnkg	nnthedfeggxxlnedfrrjf
hbpab	nnrrjdfgwbxxjxjdfthef
hccle	nmeggdgthexwwmgdggshf
hcfqg	nmbbedgwmgxwthedgjxjf
hcnkg	nmthedgeggxwlnedgrrjf
hcpab	nmrrjdggwbxwjxjdgthef
hdcle	nleggdhthexvwmgdhgshf
hdfqg	nlbbedhwmgxvthedhjxjf
hdnkg	nlthedheggxvlnedhrrjf
hdpab	nlrrjdhgwbxvjxjdhthef
hecle	nkeggdithexuwmgdigshf
hefqg	nkbbediwmgxuthedijxjf
henkg	nkthedieggxulnedirrjf
hepab	nkrrjdigwbxujxjdithef
hfcle	njeggdjthextwmgdjgshf
hffqg	njbbedjwmgxtthedjjxjf
hfnkg	njthedjeggxtlnedjrrjf
hfpab	njrrjdjgwbxtjxjdjthef
hfrta	njpykdjipaxthekdjvadf
hgcle	nieggdkthexswmgdkgshf
hgfqg	nibbedkwmgxsthedkjxjf
hgnkg	nithedkeggxslnedkrrjf
hgpab	nirrjdkgwbxsjxjdkthef
hhcle	nheggdlthexrwmgdlgshf
hhfqg	nhbbedlwmgxrthedljxjf
hhnkg	nhthedleggxrlnedlrrjf
hhpab	nhrrjdlgwbxrjxjdlthef
hicle	ngeggdmthexqwmgdmgshf
hifqg	ngbbedmwmgxqthedmjxjf
hinkg	ngthedmeggxqlnedmrrjf
hipab	ngrrjdmgwbxqjxjdmthef
hjcle	nfeggdnthexpwmgdngshf
hjfqg	nfbbednwmgxpthednjxjf
hjnkg	nfthedneggxplnednrrjf
hjpab	nfrrjdngwbxpjxjdnthef
hkcle	neeggdothexowmgdogshf
hkfqg	nebbedowmgxothedojxjf
hknkg	nethedoeggxolnedorrjf
hkpab	nerrjdogwbxojxjdothef
hlcle	ndeggdpthexnwmgdpgshf
hlfqg	ndbbedpwmgxnthedpjxjf
hlnkg	ndthedpeggxnlnedprrjf
hlpab	ndrrjdpgwbxnjxjdpthef
hmcle	nceggdqthexmwmgdqgshf
hmfqg	ncbbedqwmgxmthedqjxjf
hmnkg	ncthedqeggxmlnedqrrjf
hmpab	ncrrjdqgwbxmjxjdqthef
hncle	nbeggdrthexlwmgdrgshf
hnfqg	nbbbedrwmgxlthedrjxjf
hnnkg	nbthedreggxllnedrrrjf
hnpab	nbrrjdrgwbxljxjdrthef
hocle	naeggdsthexkwmgdsgshf
hofqg	nabbedswmgxkthedsjxjf
honkg	nathedseggxklnedsrrjf
hopab	narrjdsgwbxkjxjdsthef
hpcle	nzeggdtthexjwmgdtgshf
hpdxa	nzdukdtutaxjvakdthedf
hpfqg	nzbbedtwmgxjthedtjxjf
hpnkg	nzthedteggxjlnedtrrjf
hppab	nzrrjdtgwbxjjxjdtthef
hpqia	nzqjkdtheaxjipkdtupdf
hqcle	nyeggduthexiwmgdugshf
hqfqg	nybbeduwmgxithedujxjf
hqnkg	nythedueggxilnedurrjf
hqpab	nyrrjdugwbxijxjduthef
hrcle	nxeggdvthexhwmgdvgshf
hrfqg	nxbbedvwmgxhthedvjxjf
hrnkg	nxthedveggxhlnedvrrjf
hrpab	nxrrjdvgwbxhjxjdvthef
hscle	nweggdwthexgwmgdwgshf
hsfqg	nwbbedwwmgxgthedwjxjf
hsnkg	nwthedweggxglnedwrrjf
hspab	nwrrjdwgwbxgjxjdwthef
htcle	nveggdxthexfwmgdxgshf
htfqg	nvbbedxwmgxfthedxjxjf
htnkg	nvthedxeggxflnedxrrjf
htpab	nvrrjdxgwbxfjxjdxthef
hucle	nueggdythexewmgdygshf
hufqg	nubbedywmgxethedyjxjf
hunkg	nuthedyeggxelnedyrrjf
hupab	nurrjdygwbxejxjdythef
hvcle	nteggdzthexdwmgdzgshf
hvfqg	ntbbedzwmgxdthedzjxjf
hvnkg	ntthedzeggxdlnedzrrjf
hvpab	ntrrjdzgwbxdjxjdzthef
hvzna	nthekdzqjaxdzkkdzdudf
hwcle	nseggdathexcwmgdagshf
hwfqg	nsbbedawmgxcthedajxjf
hwnkg	nsthedaeggxclnedarrjf
hwpab	nsrrjdagwbxcjxjdathef
hxcle	nreggdbthexbwmgdbgshf
hxfqg	nrbbedbwmgxbthedbjxjf
hxnkg	nrthedbeggxblnedbrrjf
hxpab	nrrrjdbgwbxbjxjdbthef
hycle	nqeggdcthexawmgdcgshf
hyfqg	nqbbedcwmgxathedcjxjf
hynkg	nqthedceggxalnedcrrjf
hypab	nqrrjdcgwbxajxjdcthef
hzcle	npeggddthexzwmgddgshf
hzfqg	npbbeddwmgxztheddjxjf
hznkg	nptheddeggxzlneddrrjf
hzpab	nprrjddgwbxzjxjddthef
iaaed	mognheeradwyytheeelge
iaame	mogfgeeriewyylgeeethe
iaayd	mogtheerudwyyzheeefge
iabed	mofnheesadwyxtheeflge
iabme	moffgeesiewyxlgeefthe
iabyd	moftheesudwyxzheeffge
iaced	moenheetadwywtheeglge
iacle	moeggeethewywmgeegshe
iacme	moefgeetiewywlgeegthe
iacyd	moetheetudwywzheegfge
iaded	modnheeuadwyvtheehlge
iadme	modfgeeuiewyvlgeehthe
iadyd	modtheeuudwyvzheehfge
iaeed	mocnheevadwyutheeilge
iaeme	mocfgeeviewyulgeeithe
iaeyd	moctheevudwyuzheeifge
iafed	mobnheewadwyttheejlge
iafme	mobfgeewiewytlgeejthe
iafqg	mobbeeewmgwytheeejxje
iafyd	mobtheewudwytzheejfge
iaged	moanheexadwystheeklge
iagme	moafgeexiewyslgeekthe
iagyd	moatheexudwyszheekfge
iahed	moznheeyadwyrtheellge
iahme	mozfgeeyiewyrlgeelthe
iahyd	moztheeyudwyrzheelfge
iaied	moynheezadwyqtheemlge
iaime	moyfgeeziewyqlgeemthe
iaiyd	moytheezudwyqzheemfge
iajed	moxnheeaadwyptheenlge
iajme	moxfgeeaiewyplgeenthe
iajyd	moxtheeaudwypzheenfge
iaked	mownheebadwyotheeolge
iakme	mowfgeebiewyolgeeothe
iakyd	mowtheebudwyozheeofge
ialed	movnheecadwyntheeplge
ialme	movfgeeciewynlgeepthe
ialyd	movtheecudwynzheepfge
iamed	mounheedadwymtheeqlge
iamme	moufgeediewymlgeeqthe
iamyd	moutheedudwymzheeqfge
ianed	motnheeeadwyltheerlge
iankg	motheeeeggwylneeerrje
ianme	motfgeeeiewyllgeerthe
ianyd	mottheeeudwylzheerfge
iaoed	mosnheefadwyktheeslge
iaome	mosfgeefiewyklgeesthe
iaoyd	mostheefudwykzheesfge
iapab	morrjeegwbwyjxjeethee
iaped	mornheegadwyjtheetlge
iapme	morfgeegiewyjlgeetthe
iapyd	mortheegudwyjzheetfge
iaqed	moqnheehadwyitheeulge
iaqme	moqfgeehiewyilgeeuthe
iaqyd	moqtheehudwyizheeufge
iared	mopnheeiadwyhtheevlge
iarme	mopfgeeiiewyhlgeevthe
iaryd	moptheeiudwyhzheevfge
iased	moonheejadwygtheewlge
iasme	moofgeejiewyglgeewthe
iasyd	mootheejudwygzheewfge
iated	monnheekadwyftheexlge
iatme	monfgeekiewyflgeexthe
iatyd	montheekudwyfzheexfge
iaued	momnheeladwyetheeylge
iaume	momfgeeliewyelgeeythe
iauyd	momtheeludwyezheeyfge
iaved	molnheemadwydtheezlge
iavme	molfgeemiewydlgeezthe
iavyd	moltheemudwydzheezfge
iawed	moknheenadwyctheealge
iawme	mokfgeeniewyclgeeathe
iawyd	moktheenudwyczheeafge
iaxed	mojnheeoadwybtheeblge
iaxme	mojfgeeoiewyblgeebthe
iaxyd	mojtheeoudwybzheebfge
iayed	moinheepadwyatheeclge
iayme	moifgeepiewyalgeecthe
iayyd	moitheepudwyazheecfge
iazed	mohnheeqadwyztheedlge
iazme	mohfgeeqiewyzlgeedthe
iazyd	mohtheequdwyzzheedfge
ibaed	mngnhefradwxythefelge
ibame	mngfgefriewxylgefethe
ibayd	mngthefrudwxyzhefefge
ibbed	mnfnhefsadwxxthefflge
ibbme	mnffgefsiewxxlgeffthe
ibbyd	mnfthefsudwxxzhefffge
ibced	mnenheftadwxwthefglge
ibcle	mneggefthewxwmgefgshe
ibcme	mnefgeftiewxwlgefgthe
ibcyd	mnetheftudwxwzhefgfge
ibded	mndnhefuadwxvthefhlge
ibdme	mndfgefuiewxvlgefhthe
ibdyd	mndthefuudwxvzhefhfge
ibeed	mncnhefvadwxuthefilge
ibeme	mncfgefviewxulgefithe
ibeyd	mncthefvudwxuzhefifge
ibfed	mnbnhefwadwxtthefjlge
ibfme	mnbfgefwiewxtlgefjthe
ibfqg	mnbbeefwmgwxtheefjxje
ibfyd	mnbthefwudwxtzhefjfge
ibged	mnanhefxadwxsthefklge
ibgme	mnafgefxiewxslgefkthe
ibgyd	mnathefxudwxszhefkfge
ibhed	mnznhefyadwxrthefllge
ibhme	mnzfgefyiewxrlgeflthe
ibhyd	mnzthefyudwxrzheflfge
ibied	mnynhefzadwxqthefmlge
ibime	mnyfgefziewxqlgefmthe
ibiyd	mnythefzudwxqzhefmfge
ibjed	mnxnhefaadwxpthefnlge
ibjme	mnxfgefaiewxplgefnthe
ibjyd	mnxthefaudwxpzhefnfge
ibked	mnwnhefbadwxothefolge
ibkme	mnwfgefbiewxolgefothe
ibkyd	mnwthefbudwxozhefofge
ibled	mnvnhefcadwxnthefplge
iblme	mnvfgefciewxnlgefpthe
iblyd	mnvthefcudwxnzhefpfge
ibmed	mnunhefdadwxmthefqlge
ibmme	mnufgefdiewxmlgefqthe
ibmyd	mnuthefdudwxmzhefqfge
ibned	mntnhefeadwxlthefrlge
ibnkg	mntheefeggwxlneefrrje
ibnme	mntfgefeiewxllgefrthe
ibnyd	mntthefeudwxlzhefrfge
iboed	mnsnheffadwxkthefslge
ibome	mnsfgeffiewxklgefsthe
iboyd	mnstheffudwxkzhefsfge
ibpab	mnrrjefgwbwxjxjefthee
ibped	mnrnhefgadwxjtheftlge
ibpme	mnrfgefgiewxjlgeftthe
ibpyd	mnrthefgudwxjzheftfge
ibqed	mnqnhefhadwxithefulge
ibqme	mnqfgefhiewxilgefuthe
ibqyd	mnqthefhudwxizhefufge
ibred	mnpnhefiadwxhthefvlge
ibrme	mnpfgefiiewxhlgefvthe
ibryd	mnpthefiudwxhzhefvfge
ibsed	mnonhefjadwxgthefwlge
ibsme	mnofgefjiewxglgefwthe
ibsyd	mnothefjudwxgzhefwfge
ibted	mnnnhefkadwxfthefxlge
ibtme	mnnfgefkiewxflgefxthe
ibtyd	mnnthefkudwxfzhefxfge
ibued	mnmnhefladwxethefylge
ibume	mnmfgefliewxelgefythe
ibuyd	mnmthefludwxezhefyfge
ibved	mnlnhefmadwxdthefzlge
ibvme	mnlfgefmiewxdlgefzthe
ibvyd	mnlthefmudwxdzhefzfge
ibwed	mnknhefnadwxcthefalge
ibwme	mnkfgefniewxclgefathe
ibwyd	mnkthefnudwxczhefafge
ibxed	mnjnhefoadwxbthefblge
ibxme	mnjfgefoiewxblgefbthe
ibxyd	mnjthefoudwxbzhefbfge
ibyed	mninhefpadwxathefclge
ibyme	mnifgefpiewxalgefcthe
ibyyd	mnithefpudwxazhefcfge
ibzed	mnhnhefqadwxzthefdlge
ibzme	mnhfgefqiewxzlgefdthe
ibzyd	mnhthefqudwxzzhefdfge
icaed	mmgnhegradwwythegelge
icame	mmgfgegriewwylgegethe
icayd	mmgthegrudwwyzhegefge
icbed	mmfnhegsadwwxthegflge
icbme	mmffgegsiewwxlgegfthe
icbyd	mmfthegsudwwxzhegffge
icced	mmenhegtadwwwthegglge
iccle	mmeggegthewwwmgeggshe
iccme	mmefgegtiewwwlgeggthe
iccyd	mmethegtudwwwzheggfge
icded	mmdnheguadwwvtheghlge
icdme	mmdfgeguiewwvlgeghthe
icdyd	mmdtheguudwwvzheghfge
iceed	mmcnhegvadwwuthegilge
iceme	mmcfgegviewwulgegithe
iceyd	mmcthegvudwwuzhegifge
icfed	mmbnhegwadwwtthegjlge
icfme	mmbfgegwiewwtlgegjthe
icfqg	mmbbeegwmgwwtheegjxje
icfyd	mmbthegwudwwtzhegjfge
icged	mmanhegxadwwsthegklge
icgme	mmafgegxiewwslgegkthe
icgyd	mmathegxudwwszhegkfge
iched	mmznhegyadwwrthegllge
ichme	mmzfgegyiewwrlgeglthe
ichyd	mmzthegyudwwrzheglfge
icied	mmynhegzadwwqthegmlge
icime	mmyfgegziewwqlgegmthe
iciyd	mmythegzudwwqzhegmfge
icjed	mmxnhegaadwwpthegnlge
icjme	mmxfgegaiewwplgegnthe
icjyd	mmxthegaudwwpzhegnfge
icked	mmwnhegbadwwothegolge
ickme	mmwfgegbiewwolgegothe
ickyd	mmwthegbudwwozhegofge
icled	mmvnhegcadwwnthegplge
iclme	mmvfgegciewwnlgegpthe
iclyd	mmvthegcudwwnzhegpfge
icmed	mmunhegdadwwmthegqlge
icmme	mmufgegdiewwmlgegqthe
icmyd	mmuthegdudwwmzhegqfge
icned	mmtnhegeadwwlthegrlge
icnkg	mmtheegeggwwlneegrrje
icnme	mmtfgegeiewwllgegrthe
icnyd	mmtthegeudwwlzhegrfge
icoed	mmsnhegfadwwkthegslge
icome	mmsfgegfiewwklgegsthe
icoyd	mmsthegfudwwkzhegsfge
icpab	mmrrjeggwbwwjxjegthee
icped	mmrnheggadwwjthegtlge
icpme	mmrfgeggiewwjlgegtthe
icpyd	mmrtheggudwwjzhegtfge
icqed	mmqnheghadwwithegulge
icqme	mmqfgeghiewwilgeguthe
icqyd	mmqtheghudwwizhegufge
icred	mmpnhegiadwwhthegvlge
icrme	mmpfgegiiewwhlgegvthe
icryd	mmpthegiudwwhzhegvfge
icsed	mmonhegjadwwgthegwlge
icsme	mmofgegjiewwglgegwthe
icsyd	mmothegjudwwgzhegwfge
icted	mmnnhegkadwwfthegxlge
ictme	mmnfgegkiewwflgegxthe
ictyd	mmnthegkudwwfzhegxfge
icued	mmmnhegladwwethegylge
icume	mmmfgegliewwelgegythe
icuyd	mmmthegludwwezhegyfge
icved	mmlnhegmadwwdthegzlge
icvme	mmlfgegmiewwdlgegzthe
icvyd	mmlthegmudwwdzhegzfge
icwed	mmknhegnadwwcthegalge
icwme	mmkfgegniewwclgegathe
icwyd	mmkthegnudwwczhegafge
icxed	mmjnhegoadwwbthegblge
icxme	mmjfgegoiewwblgegbthe
icxyd	mmjthegoudwwbzhegbfge
icyed	mminhegpadwwathegclge
icyme	mmifgegpiewwalgegcthe
icyyd	mmithegpudwwazhegcfge
iczed	mmhnhegqadwwzthegdlge
iczme	mmhfgegqiewwzlgegdthe
iczyd	mmhthegqudwwzzhegdfge
idaed	mlgnhehradwvythehelge
idame	mlgfgehriewvylgehethe
idayd	mlgthehrudwvyzhehefge
idbed	mlfnhehsadwvxthehflge
idbme	mlffgehsiewvxlgehfthe
idbyd	mlfthehsudwvxzhehffge
idced	mlenhehtadwvwthehglge
idcle	mleggehthewvwmgehgshe
idcme	mlefgehtiewvwlgehgthe
idcyd	mlethehtudwvwzhehgfge
idded	mldnhehuadwvvthehhlge
iddme	mldfgehuiewvvlgehhthe
iddyd	mldthehuudwvvzhehhfge
ideed	mlcnhehvadwvuthehilge
ideme	mlcfgehviewvulgehithe
ideyd	mlcthehvudwvuzhehifge
idfed	mlbnhehwadwvtthehjlge
idfme	mlbfgehwiewvtlgehjthe
idfqg	mlbbeehwmgwvtheehjxje
idfyd	mlbthehwudwvtzhehjfge
idged	mlanhehxadwvsthehklge
idgme	mlafgehxiewvslgehkthe
idgyd	mlathehxudwvszhehkfge
idhed	mlznhehyadwvrthehllge
idhme	mlzfgehyiewvrlgehlthe
idhyd	mlzthehyudwvrzhehlfge
idied	mlynhehzadwvqthehmlge
idime	mlyfgehziewvqlgehmthe
idiyd	mlythehzudwvqzhehmfge
idjed	mlxnhehaadwvpthehnlge
idjme	mlxfgehaiewvplgehnthe
idjyd	mlxthehaudwvpzhehnfge
idked	mlwnhehbadwvotheholge
idkme	mlwfgehbiewvolgehothe
idkyd	mlwthehbudwvozhehofge
idled	mlvnhehcadwvnthehplge
idlme	mlvfgehciewvnlgehpthe
idlyd	mlvthehcudwvnzhehpfge
idmed	mlunhehdadwvmthehqlge
idmme	mlufgehdiewvmlgehqthe
idmyd	mluthehdudwvmzhehqfge
idned	mltnheheadwvlthehrlge
idnkg	mltheeheggwvlneehrrje
idnme	mltfgeheiewvllgehrthe
idnyd	mlttheheudwvlzhehrfge
idoed	mlsnhehfadwvkthehslge
idome	mlsfgehfiewvklgehsthe
idoyd	mlsthehfudwvkzhehsfge
idpab	mlrrjehgwbwvjxjehthee
idped	mlrnhehgadwvjthehtlge
idpme	mlrfgehgiewvjlgehtthe
idpyd	mlrthehgudwvjzhehtfge
idqed	mlqnhehhadwvithehulge
idqme	mlqfgehhiewvilgehuthe
idqyd	mlqthehhudwvizhehufge
idred	mlpnhehiadwvhthehvlge
idrme	mlpfgehiiewvhlgehvthe
idryd	mlpthehiudwvhzhehvfge
idsed	mlonhehjadwvgthehwlge
idsme	mlofgehjiewvglgehwthe
idsyd	mlothehjudwvgzhehwfge
idted	mlnnhehkadwvfthehxlge
idtme	mlnfgehkiewvflgehxthe
idtyd	mlnthehkudwvfzhehxfge
idued	mlmnhehladwvethehylge
idume	mlmfgehliewvelgehythe
iduyd	mlmthehludwvezhehyfge
idved	mllnhehmadwvdthehzlge
idvme	mllfgehmiewvdlgehzthe
idvyd	mllthehmudwvdzhehzfge
idwed	mlknhehnadwvcthehalge
idwme	mlkfgehniewvclgehathe
idwyd	mlkthehnudwvczhehafge
idxed	mljnhehoadwvbthehblge
idxme	mljfgehoiewvblgehbthe
idxyd	mljthehoudwvbzhehbfge
idyed	mlinhehpadwvathehclge
idyme	mlifgehpiewvalgehcthe
idyyd	mlithehpudwvazhehcfge
idzed	mlhnhehqadwvzthehdlge
idzme	mlhfgehqiewvzlgehdthe
idzyd	mlhthehqudwvzzhehdfge
ieaed	mkgnheiradwuytheielge
ieame	mkgfgeiriewuylgeiethe
ieayd	mkgtheirudwuyzheiefge
iebed	mkfnheisadwuxtheiflge
iebme	mkffgeisiewuxlgeifthe
iebyd	mkftheisudwuxzheiffge
ieced	mkenheitadwuwtheiglge
iecle	mkeggeithewuwmgeigshe
iecme	mkefgeitiewuwlgeigthe
iecyd	mketheitudwuwzheigfge
ieded	mkdnheiuadwuvtheihlge
iedme	mkdfgeiuiewuvlgeihthe
iedyd	mkdtheiuudwuvzheihfge
ieeed	mkcnheivadwuutheiilge
ieeme	mkcfgeiviewuulgeiithe
ieeyd	mkctheivudwuuzheiifge
iefed	mkbnheiwadwuttheijlge
iefme	mkbfgeiwiewutlgeijthe
iefqg	mkbbeeiwmgwutheeijxje
iefyd	mkbtheiwudwutzheijfge
ieged	mkanheixadwustheiklge
iegme	mkafgeixiewuslgeikthe
iegyd	mkatheixudwuszheikfge
iehed	mkznheiyadwurtheillge
iehme	mkzfgeiyiewurlgeilthe
iehyd	mkztheiyudwurzheilfge
ieied	mkynheizadwuqtheimlge
ieime	mkyfgeiziewuqlgeimthe
ieiyd	mkytheizudwuqzheimfge
iejed	mkxnheiaadwuptheinlge
iejme	mkxfgeiaiewuplgeinthe
iejyd	mkxtheiaudwupzheinfge
ieked	mkwnheibadwuotheiolge
iekme	mkwfgeibiewuolgeiothe
iekyd	mkwtheibudwuozheiofge
ieled	mkvnheicadwuntheiplge
ielme	mkvfgeiciewunlgeipthe
ielyd	mkvtheicudwunzheipfge
iemed	mkunheidadwumtheiqlge
iemme	mkufgeidiewumlgeiqthe
iemyd	mkutheidudwumzheiqfge
iened	mktnheieadwultheirlge
ienkg	mktheeieggwulneeirrje
ienme	mktfgeieiewullgeirthe
ienyd	mkttheieudwulzheirfge
ieoed	mksnheifadwuktheislge
ieome	mksfgeifiewuklgeisthe
ieoyd	mkstheifudwukzheisfge
iepab	mkrrjeigwbwujxjeithee
ieped	mkrnheigadwujtheitlge
iepme	mkrfgeigiewujlgeitthe
iepyd	mkrtheigudwujzheitfge
ieqed	mkqnheihadwuitheiulge
ieqme	mkqfgeihiewuilgeiuthe
ieqyd	mkqtheihudwuizheiufge
iered	mkpnheiiadwuhtheivlge
ierme	mkpfgeiiiewuhlgeivthe
ieryd	mkptheiiudwuhzheivfge
iesed	mkonheijadwugtheiwlge
iesme	mkofgeijiewuglgeiwthe
iesyd	mkotheijudwugzheiwfge
ieted	mknnheikadwuftheixlge
ietme	mknfgeikiewuflgeixthe
ietyd	mkntheikudwufzheixfge
ieued	mkmnheiladwuetheiylge
ieume	mkmfgeiliewuelgeiythe
ieuyd	mkmtheiludwuezheiyfge
ieved	mklnheimadwudtheizlge
ievme	mklfgeimiewudlgeizthe
ievyd	mkltheimudwudzheizfge
iewed	mkknheinadwuctheialge
iewme	mkkfgeiniewuclgeiathe
iewyd	mkktheinudwuczheiafge
iexed	mkjnheioadwubtheiblge
iexme	mkjfgeioiewublgeibthe
iexyd	mkjtheioudwubzheibfge
ieyed	mkinheipadwuatheiclge
ieyme	mkifgeipiewualgeicthe
ieyyd	mkitheipudwuazheicfge
iezed	mkhnheiqadwuztheidlge
iezme	mkhfgeiqiewuzlgeidthe
iezyd	mkhtheiqudwuzzheidfge
ifaed	mjgnhejradwtythejelge
ifame	mjgfgejriewtylgejethe
ifayd	mjgthejrudwtyzhejefge
ifbed	mjfnhejsadwtxthejflge
ifbme	mjffgejsiewtxlgejfthe
ifbyd	mjfthejsudwtxzhejffge
ifced	mjenhejtadwtwthejglge
ifcle	mjeggejthewtwmgejgshe
ifcme	mjefgejtiewtwlgejgthe
ifcyd	mjethejtudwtwzhejgfge
ifded	mjdnhejuadwtvthejhlge
ifdme	mjdfgejuiewtvlgejhthe
ifdyd	mjdthejuudwtvzhejhfge
ifeed	mjcnhejvadwtuthejilge
ifeme	mjcfgejviewtulgejithe
ifeyd	mjcthejvudwtuzhejifge
iffed	mjbnhejwadwttthejjlge
iffme	mjbfgejwiewttlgejjthe
iffqg	mjbbeejwmgwttheejjxje
iffyd	mjbthejwudwttzhejjfge
ifged	mjanhejxadwtsthejklge
ifgme	mjafgejxiewtslgejkthe
ifgyd	mjathejxudwtszhejkfge
ifhed	mjznhejyadwtrthejllge
ifhme	mjzfgejyiewtrlgejlthe
ifhyd	mjzthejyudwtrzhejlfge
ified	mjynhejzadwtqthejmlge
ifime	mjyfgejziewtqlgejmthe
ifiyd	mjythejzudwtqzhejmfge
ifjed	mjxnhejaadwtpthejnlge
ifjme	mjxfgejaiewtplgejnthe
ifjyd	mjxthejaudwtpzhejnfge
ifked	mjwnhejbadwtothejolge
ifkme	mjwfgejbiewtolgejothe
ifkyd	mjwthejbudwtozhejofge
ifled	mjvnhejcadwtnthejplge
iflme	mjvfgejciewtnlgejpthe
iflyd	mjvthejcudwtnzhejpfge
ifmed	mjunhejdadwtmthejqlge
ifmme	mjufgejdiewtmlgejqthe
ifmyd	mjuthejdudwtmzhejqfge
ifned	mjtnhejeadwtlthejrlge
ifnkg	mjtheejeggwtlneejrrje
ifnme	mjtfgejeiewtllgejrthe
ifnyd	mjtthejeudwtlzhejrfge
ifoed	mjsnhejfadwtkthejslge
ifome	mjsfgejfiewtklgejsthe
ifoyd	mjsthejfudwtkzhejsfge
ifpab	mjrrjejgwbwtjxjejthee
ifped	mjrnhejgadwtjthejtlge
ifpme	mjrfgejgiewtjlgejtthe
ifpyd	mjrthejgudwtjzhejtfge
ifqed	mjqnhejhadwtithejulge
ifqme	mjqfgejhiewtilgejuthe
ifqyd	mjqthejhudwtizhejufge
ifred	mjpnhejiadwththejvlge
ifrme	mjpfgejiiewthlgejvthe
ifrta	mjpykejipawthekejvade
ifryd	mjpthejiudwthzhejvfge
ifsed	mjonhejjadwtgthejwlge
ifsme	mjofgejjiewtglgejwthe
ifsyd	mjothejjudwtgzhejwfge
ifted	mjnnhejkadwtfthejxlge
iftme	mjnfgejkiewtflgejxthe
iftyd	mjnthejkudwtfzhejxfge
ifued	mjmnhejladwtethejylge
ifume	mjmfgejliewtelgejythe
ifuyd	mjmthejludwtezhejyfge
ifved	mjlnhejmadwtdthejzlge
ifvme	mjlfgejmiewtdlgejzthe
ifvyd	mjlthejmudwtdzhejzfge
ifwed	mjknhejnadwtcthejalge
ifwme	mjkfgejniewtclgejathe
ifwyd	mjkthejnudwtczhejafge
ifxed	mjjnhejoadwtbthejblge
ifxme	mjjfgejoiewtblgejbthe
ifxyd	mjjthejoudwtbzhejbfge
ifyed	mjinhejpadwtathejclge
ifyme	mjifgejpiewtalgejcthe
ifyyd	mjithejpudwtazhejcfge
ifzed	mjhnhejqadwtzthejdlge
ifzme	mjhfgejqiewtzlgejdthe
ifzyd	mjhthejqudwtzzhejdfge
igaed	mignhekradwsythekelge
igame	migfgekriewsylgekethe
igayd	migthekrudwsyzhekefge
igbed	mifnheksadwsxthekflge
igbme	miffgeksiewsxlgekfthe
igbyd	miftheksudwsxzhekffge
igced	mienhektadwswthekglge
igcle	mieggekthewswmgekgshe
igcme	miefgektiewswlgekgthe
igcyd	miethektudwswzhekgfge
igded	midnhekuadwsvthekhlge
igdme	midfgekuiewsvlgekhthe
igdyd	midthekuudwsvzhekhfge
igeed	micnhekvadwsuthekilge
igeme	micfgekviewsulgekithe
igeyd	micthekvudwsuzhekifge
igfed	mibnhekwadwstthekjlge
igfme	mibfgekwiewstlgekjthe
igfqg	mibbeekwmgwstheekjxje
igfyd	mibthekwudwstzhekjfge
igged	mianhekxadwssthekklge
iggme	miafgekxiewsslgekkthe
iggyd	miathekxudwsszhekkfge
ighed	miznhekyadwsrthekllge
ighme	mizfgekyiewsrlgeklthe
ighyd	mizthekyudwsrzheklfge
igied	miynhekzadwsqthekmlge
igime	miyfgekziewsqlgekmthe
igiyd	miythekzudwsqzhekmfge
igjed	mixnhekaadwsptheknlge
igjme	mixfgekaiewsplgeknthe
igjyd	mixthekaudwspzheknfge
igked	miwnhekbadwsothekolge
igkme	miwfgekbiewsolgekothe
igkyd	miwthekbudwsozhekofge
igled	mivnhekcadwsnthekplge
iglme	mivfgekciewsnlgekpthe
iglyd	mivthekcudwsnzhekpfge
igmed	miunhekdadwsmthekqlge
igmme	miufgekdiewsmlgekqthe
igmyd	miuthekdudwsmzhekqfge
igned	mitnhekeadwslthekrlge
ignkg	mitheekeggwslneekrrje
ignme	mitfgekeiewsllgekrthe
ignyd	mitthekeudwslzhekrfge
igoed	misnhekfadwskthekslge
igome	misfgekfiewsklgeksthe
igoyd	misthekfudwskzheksfge
igpab	mirrjekgwbwsjxjekthee
igped	mirnhekgadwsjthektlge
igpme	mirfgekgiewsjlgektthe
igpyd	mirthekgudwsjzhektfge
igqed	miqnhekhadwsithekulge
igqme	miqfgekhiewsilgekuthe
igqyd	miqthekhudwsizhekufge
igred	mipnhekiadwshthekvlge
igrme	mipfgekiiewshlgekvthe
igryd	mipthekiudwshzhekvfge
igsed	mionhekjadwsgthekwlge
igsme	miofgekjiewsglgekwthe
igsyd	miothekjudwsgzhekwfge
igted	minnhekkadwsfthekxlge
igtme	minfgekkiewsflgekxthe
igtyd	minthekkudwsfzhekxfge
igued	mimnhekladwsethekylge
igume	mimfgekliewselgekythe
iguyd	mimthekludwsezhekyfge
igved	milnhekmadwsdthekzlge
igvme	milfgekmiewsdlgekzthe
igvyd	milthekmudwsdzhekzfge
igwed	miknheknadwscthekalge
igwme	mikfgekniewsclgekathe
igwyd	miktheknudwsczhekafge
igxed	mijnhekoadwsbthekblge
igxme	mijfgekoiewsblgekbthe
igxyd	mijthekoudwsbzhekbfge
igyed	miinhekpadwsathekclge
igyme	miifgekpiewsalgekcthe
igyyd	miithekpudwsazhekcfge
igzed	mihnhekqadwszthekdlge
igzme	mihfgekqiewszlgekdthe
igzyd	mihthekqudwszzhekdfge
ihaed	mhgnhelradwrythelelge
ihame	mhgfgelriewrylgelethe
ihayd	mhgthelrudwryzhelefge
ihbed	mhfnhelsadwrxthelflge
ihbme	mhffgelsiewrxlgelfthe
ihbyd	mhfthelsudwrxzhelffge
ihced	mhenheltadwrwthelglge
ihcle	mheggelthewrwmgelgshe
ihcme	mhefgeltiewrwlgelgthe
ihcyd	mhetheltudwrwzhelgfge
ihded	mhdnheluadwrvthelhlge
ihdme	mhdfgeluiewrvlgelhthe
ihdyd	mhdtheluudwrvzhelhfge
iheed	mhcnhelvadwruthelilge
iheme	mhcfgelviewrulgelithe
iheyd	mhcthelvudwruzhelifge
ihfed	mhbnhelwadwrttheljlge
ihfme	mhbfgelwiewrtlgeljthe
ihfqg	mhbbeelwmgwrtheeljxje
ihfyd	mhbthelwudwrtzheljfge
ihged	mhanhelxadwrsthelklge
ihgme	mhafgelxiewrslgelkthe
ihgyd	mhathelxudwrszhelkfge
ihhed	mhznhelyadwrrthelllge
ihhme	mhzfgelyiewrrlgellthe
ihhyd	mhzthelyudwrrzhellfge
ihied	mhynhelzadwrqthelmlge
ihime	mhyfgelziewrqlgelmthe
ihiyd	mhythelzudwrqzhelmfge
ihjed	mhxnhelaadwrpthelnlge
ihjme	mhxfgelaiewrplgelnthe
ihjyd	mhxthelaudwrpzhelnfge
ihked	mhwnhelbadwrothelolge
ihkme	mhwfgelbiewrolgelothe
ihkyd	mhwthelbudwrozhelofge
ihled	mhvnhelcadwrnthelplge
ihlme	mhvfgelciewrnlgelpthe
ihlyd	mhvthelcudwrnzhelpfge
ihmed	mhunheldadwrmthelqlge
ihmme	mhufgeldiewrmlgelqthe
ihmyd	mhutheldudwrmzhelqfge
ihned	mhtnheleadwrlthelrlge
ihnkg	mhtheeleggwrlneelrrje
ihnme	mhtfgeleiewrllgelrthe
ihnyd	mhttheleudwrlzhelrfge
ihoed	mhsnhelfadwrkthelslge
ihome	mhsfgelfiewrklgelsthe
ihoyd	mhsthelfudwrkzhelsfge
ihpab	mhrrjelgwbwrjxjelthee
ihped	mhrnhelgadwrjtheltlge
ihpme	mhrfgelgiewrjlgeltthe
ihpyd	mhrthelgudwrjzheltfge
ihqed	mhqnhelhadwrithelulge
ihqme	mhqfgelhiewrilgeluthe
ihqyd	mhqthelhudwrizhelufge
ihred	mhpnheliadwrhthelvlge
ihrme	mhpfgeliiewrhlgelvthe
ihryd	mhptheliudwrhzhelvfge
ihsed	mhonheljadwrgthelwlge
ihsme	mhofgeljiewrglgelwthe
ihsyd	mhotheljudwrgzhelwfge
ihted	mhnnhelkadwrfthelxlge
ihtme	mhnfgelkiewrflgelxthe
ihtyd	mhnthelkudwrfzhelxfge
ihued	mhmnhelladwrethelylge
ihume	mhmfgelliewrelgelythe
ihuyd	mhmthelludwrezhelyfge
ihved	mhlnhelmadwrdthelzlge
ihvme	mhlfgelmiewrdlgelzthe
ihvyd	mhlthelmudwrdzhelzfge
ihwed	mhknhelnadwrcthelalge
ihwme	mhkfgelniewrclgelathe
ihwyd	mhkthelnudwrczhelafge
ihxed	mhjnheloadwrbthelblge
ihxme	mhjfgeloiewrblgelbthe
ihxyd	mhjtheloudwrbzhelbfge
ihyed	mhinhelpadwrathelclge
ihyme	mhifgelpiewralgelcthe
ihyyd	mhithelpudwrazhelcfge
ihzed	mhhnhelqadwrztheldlge
ihzme	mhhfgelqiewrzlgeldthe
ihzyd	mhhthelqudwrzzheldfge
iiaed	mggnhemradwqythemelge
iiame	mggfgemriewqylgemethe
iiayd	mggthemrudwqyzhemefge
iibed	mgfnhemsadwqxthemflge
iibme	mgffgemsiewqxlgemfthe
iibyd	mgfthemsudwqxzhemffge
iiced	mgenhemtadwqwthemglge
iicle	mgeggemthewqwmgemgshe
iicme	mgefgemtiewqwlgemgthe
iicyd	mgethemtudwqwzhemgfge
iided	mgdnhemuadwqvthemhlge
iidme	mgdfgemuiewqvlgemhthe
iidyd	mgdthemuudwqvzhemhfge
iieed	mgcnhemvadwquthemilge
iieme	mgcfgemviewqulgemithe
iieyd	mgcthemvudwquzhemifge
iifed	mgbnhemwadwqtthemjlge
iifme	mgbfgemwiewqtlgemjthe
iifqg	mgbbeemwmgwqtheemjxje
iifyd	mgbthemwudwqtzhemjfge
iiged	mganhemxadwqsthemklge
iigme	mgafgemxiewqslgemkthe
iigyd	mgathemxudwqszhemkfge
iihed	mgznhemyadwqrthemllge
iihme	mgzfgemyiewqrlgemlthe
iihyd	mgzthemyudwqrzhemlfge
iiied	mgynhemzadwqqthemmlge
iiime	mgyfgemziewqqlgemmthe
iiiyd	mgythemzudwqqzhemmfge
iijed	mgxnhemaadwqpthemnlge
iijme	mgxfgemaiewqplgemnthe
iijyd	mgxthemaudwqpzhemnfge
iiked	mgwnhembadwqothemolge
iikme	mgwfgembiewqolgemothe
iikyd	mgwthembudwqozhemofge
iiled	mgvnhemcadwqnthemplge
iilme	mgvfgemciewqnlgempthe
iilyd	mgvthemcudwqnzhempfge
iimed	mgunhemdadwqmthemqlge
iimme	mgufgemdiewqmlgemqthe
iimyd	mguthemdudwqmzhemqfge
iined	mgtnhemeadwqlthemrlge
iinkg	mgtheemeggwqlneemrrje
iinme	mgtfgemeiewqllgemrthe
iinyd	mgtthemeudwqlzhemrfge
iioed	mgsnhemfadwqkthemslge
iiome	mgsfgemfiewqklgemsthe
iioyd	mgsthemfudwqkzhemsfge
iipab	mgrrjemgwbwqjxjemthee
iiped	mgrnhemgadwqjthemtlge
iipme	mgrfgemgiewqjlgemtthe
iipyd	mgrthemgudwqjzhemtfge
iiqed	mgqnhemhadwqithemulge
iiqme	mgqfgemhiewqilgemuthe
iiqyd	mgqthemhudwqizhemufge
iired	mgpnhemiadwqhthemvlge
iirme	mgpfgemiiewqhlgemvthe
iiryd	mgpthemiudwqhzhemvfge
iised	mgonhemjadwqgthemwlge
iisme	mgofgemjiewqglgemwthe
iisyd	mgothemjudwqgzhemwfge
iited	mgnnhemkadwqfthemxlge
iitme	mgnfgemkiewqflgemxthe
iityd	mgnthemkudwqfzhemxfge
iiued	mgmnhemladwqethemylge
iiume	mgmfgemliewqelgemythe
iiuyd	mgmthemludwqezhemyfge
iived	mglnhemmadwqdthemzlge
iivme	mglfgemmiewqdlgemzthe
iivyd	mglthemmudwqdzhemzfge
iiwed	mgknhemnadwqcthemalge
iiwme	mgkfgemniewqclgemathe
iiwyd	mgkthemnudwqczhemafge
iixed	mgjnhemoadwqbthemblge
iixme	mgjfgemoiewqblgembthe
iixyd	mgjthemoudwqbzhembfge
iiyed	mginhempadwqathemclge
iiyme	mgifgempiewqalgemcthe
iiyyd	mgithempudwqazhemcfge
iized	mghnhemqadwqzthemdlge
iizme	mghfgemqiewqzlgemdthe
iizyd	mghthemqudwqzzhemdfge
ijaed	mfgnhenradwpythenelge
ijame	mfgfgenriewpylgenethe
ijayd	mfgthenrudwpyzhenefge
ijbed	mffnhensadwpxthenflge
ijbme	mfffgensiewpxlgenfthe
ijbyd	mffthensudwpxzhenffge
ijced	mfenhentadwpwthenglge
ijcle	mfeggenthewpwmgengshe
ijcme	mfefgentiewpwlgengthe
ijcyd	mfethentudwpwzhengfge
ijded	mfdnhenuadwpvthenhlge
ijdme	mfdfgenuiewpvlgenhthe
ijdyd	mfdthenuudwpvzhenhfge
ijeed	mfcnhenvadwputhenilge
ijeme	mfcfgenviewpulgenithe
ijeyd	mfcthenvudwpuzhenifge
ijfed	mfbnhenwadwptthenjlge
ijfme	mfbfgenwiewptlgenjthe
ijfqg	mfbbeenwmgwptheenjxje
ijfyd	mfbthenwudwptzhenjfge
ijged	mfanhenxadwpsthenklge
ijgme	mfafgenxiewpslgenkthe
ijgyd	mfathenxudwpszhenkfge
ijhed	mfznhenyadwprthenllge
ijhme	mfzfgenyiewprlgenlthe
ijhyd	mfzthenyudwprzhenlfge
ijied	mfynhenzadwpqthenmlge
ijime	mfyfgenziewpqlgenmthe
ijiyd	mfythenzudwpqzhenmfge
ijjed	mfxnhenaadwppthennlge
ijjme	mfxfgenaiewpplgennthe
ijjyd	mfxthenaudwppzhennfge
ijked	mfwnhenbadwpothenolge
ijkme	mfwfgenbiewpolgenothe
ijkyd	mfwthenbudwpozhenofge
ijled	mfvnhencadwpnthenplge
ijlme	mfvfgenciewpnlgenpthe
ijlyd	mfvthencudwpnzhenpfge
ijmed	mfunhendadwpmthenqlge
ijmme	mfufgendiewpmlgenqthe
ijmyd	mfuthendudwpmzhenqfge
ijned	mftnheneadwplthenrlge
ijnkg	mftheeneggwplneenrrje
ijnme	mftfgeneiewpllgenrthe
ijnyd	mfttheneudwplzhenrfge
ijoed	mfsnhenfadwpkthenslge
ijome	mfsfgenfiewpklgensthe
ijoyd	mfsthenfudwpkzhensfge
ijpab	mfrrjengwbwpjxjenthee
ijped	mfrnhengadwpjthentlge
ijpme	mfrfgengiewpjlgentthe
ijpyd	mfrthengudwpjzhentfge
ijqed	mfqnhenhadwpithenulge
ijqme	mfqfgenhiewpilgenuthe
ijqyd	mfqthenhudwpizhenufge
ijred	mfpnheniadwphthenvlge
ijrme	mfpfgeniiewphlgenvthe
ijryd	mfptheniudwphzhenvfge
ijsed	mfonhenjadwpgthenwlge
ijsme	mfofgenjiewpglgenwthe
ijsyd	mfothenjudwpgzhenwfge
ijted	mfnnhenkadwpfthenxlge
ijtme	mfnfgenkiewpflgenxthe
ijtyd	mfnthenkudwpfzhenxfge
ijued	mfmnhenladwpethenylge
ijume	mfmfgenliewpelgenythe
ijuyd	mfmthenludwpezhenyfge
ijved	mflnhenmadwpdthenzlge
ijvme	mflfgenmiewpdlgenzthe
ijvyd	mflthenmudwpdzhenzfge
ijwed	mfknhennadwpcthenalge
ijwme	mfkfgenniewpclgenathe
ijwyd	mfkthennudwpczhenafge
ijxed	mfjnhenoadwpbthenblge
ijxme	mfjfgenoiewpblgenbthe
ijxyd	mfjthenoudwpbzhenbfge
ijyed	mfinhenpadwpathenclge
ijyme	mfifgenpiewpalgencthe
ijyyd	mfithenpudwpazhencfge
ijzed	mfhnhenqadwpzthendlge
ijzme	mfhfgenqiewpzlgendthe
ijzyd	mfhthenqudwpzzhendfge
ikaed	megnheoradwoytheoelge
ikame	megfgeoriewoylgeoethe
ikayd	megtheorudwoyzheoefge
ikbed	mefnheosadwoxtheoflge
ikbme	meffgeosiewoxlgeofthe
ikbyd	meftheosudwoxzheoffge
ikced	meenheotadwowtheoglge
ikcle	meeggeothewowmgeogshe
ikcme	meefgeotiewowlgeogthe
ikcyd	meetheotudwowzheogfge
ikded	mednheouadwovtheohlge
ikdme	medfgeouiewovlgeohthe
ikdyd	medtheouudwovzheohfge
ikeed	mecnheovadwoutheoilge
ikeme	mecfgeoviewoulgeoithe
ikeyd	mectheovudwouzheoifge
ikfed	mebnheowadwottheojlge
ikfme	mebfgeowiewotlgeojthe
ikfqg	mebbeeowmgwotheeojxje
ikfyd	mebtheowudwotzheojfge
ikged	meanheoxadwostheoklge
ikgme	meafgeoxiewoslgeokthe
ikgyd	meatheoxudwoszheokfge
ikhed	meznheoyadwortheollge
ikhme	mezfgeoyieworlgeolthe
ikhyd	meztheoyudworzheolfge
ikied	meynheozadwoqtheomlge
ikime	meyfgeoziewoqlgeomthe
ikiyd	meytheozudwoqzheomfge
ikjed	mexnheoaadwoptheonlge
ikjme	mexfgeoaiewoplgeonthe
ikjyd	mextheoaudwopzheonfge
ikked	mewnheobadwootheoolge
ikkme	mewfgeobiewoolgeoothe
ikkyd	mewtheobudwoozheoofge
ikled	mevnheocadwontheoplge
iklme	mevfgeociewonlgeopthe
iklyd	mevtheocudwonzheopfge
ikmed	meunheodadwomtheoqlge
ikmme	meufgeodiewomlgeoqthe
ikmyd	meutheodudwomzheoqfge
ikned	metnheoeadwoltheorlge
iknkg	metheeoeggwolneeorrje
iknme	metfgeoeiewollgeorthe
iknyd	mettheoeudwolzheorfge
ikoed	mesnheofadwoktheoslge
ikome	mesfgeofiewoklgeosthe
ikoyd	mestheofudwokzheosfge
ikpab	merrjeogwbwojxjeothee
ikped	mernheogadwojtheotlge
ikpme	merfgeogiewojlgeotthe
ikpyd	mertheogudwojzheotfge
ikqed	meqnheohadwoitheoulge
ikqme	meqfgeohiewoilgeouthe
ikqyd	meqtheohudwoizheoufge
ikred	mepnheoiadwohtheovlge
ikrme	mepfgeoiiewohlgeovthe
ikryd	meptheoiudwohzheovfge
iksed	meonheojadwogtheowlge
iksme	meofgeojiewoglgeowthe
iksyd	meotheojudwogzheowfge
ikted	mennheokadwoftheoxlge
iktme	menfgeokiewoflgeoxthe
iktyd	mentheokudwofzheoxfge
ikued	memnheoladwoetheoylge
ikume	memfgeoliewoelgeoythe
ikuyd	memtheoludwoezheoyfge
ikved	melnheomadwodtheozlge
ikvme	melfgeomiewodlgeozthe
ikvyd	meltheomudwodzheozfge
ikwed	meknheonadwoctheoalge
ikwme	mekfgeoniewoclgeoathe
ikwyd	mektheonudwoczheoafge
ikxed	mejnheooadwobtheoblge
ikxme	mejfgeooiewoblgeobthe
ikxyd	mejtheooudwobzheobfge
ikyed	meinheopadwoatheoclge
ikyme	meifgeopiewoalgeocthe
ikyyd	meitheopudwoazheocfge
ikzed	mehnheoqadwoztheodlge
ikzme	mehfgeoqiewozlgeodthe
ikzyd	mehtheoqudwozzheodfge
ilaed	mdgnhepradwnythepelge
ilame	mdgfgepriewnylgepethe
ilayd	mdgtheprudwnyzhepefge
ilbed	mdfnhepsadwnxthepflge
ilbme	mdffgepsiewnxlgepfthe
ilbyd	mdfthepsudwnxzhepffge
ilced	mdenheptadwnwthepglge
ilcle	mdeggepthewnwmgepgshe
ilcme	mdefgeptiewnwlgepgthe
ilcyd	mdetheptudwnwzhepgfge
ilded	mddnhepuadwnvthephlge
ildme	mddfgepuiewnvlgephthe
ildyd	mddthepuudwnvzhephfge
ileed	mdcnhepvadwnuthepilge
ileme	mdcfgepviewnulgepithe
ileyd	mdcthepvudwnuzhepifge
ilfed	mdbnhepwadwntthepjlge
ilfme	mdbfgepwiewntlgepjthe
ilfqg	mdbbeepwmgwntheepjxje
ilfyd	mdbthepwudwntzhepjfge
ilged	mdanhepxadwnsthepklge
ilgme	mdafgepxiewnslgepkthe
ilgyd	mdathepxudwnszhepkfge
ilhed	mdznhepyadwnrthepllge
ilhme	mdzfgepyiewnrlgeplthe
ilhyd	mdzthepyudwnrzheplfge
ilied	mdynhepzadwnqthepmlge
ilime	mdyfgepziewnqlgepmthe
iliyd	mdythepzudwnqzhepmfge
iljed	mdxnhepaadwnpthepnlge
iljme	mdxfgepaiewnplgepnthe
iljyd	mdxthepaudwnpzhepnfge
ilked	mdwnhepbadwnothepolge
ilkme	mdwfgepbiewnolgepothe
ilkyd	mdwthepbudwnozhepofge
illed	mdvnhepcadwnnthepplge
illme	mdvfgepciewnnlgeppthe
illyd	mdvthepcudwnnzheppfge
ilmed	mdunhepdadwnmthepqlge
ilmme	mdufgepdiewnmlgepqthe
ilmyd	mduthepdudwnmzhepqfge
ilned	mdtnhepeadwnltheprlge
ilnkg	mdtheepeggwnlneeprrje
ilnme	mdtfgepeiewnllgeprthe
ilnyd	mdtthepeudwnlzheprfge
iloed	mdsnhepfadwnkthepslge
ilome	mdsfgepfiewnklgepsthe
iloyd	mdsthepfudwnkzhepsfge
ilpab	mdrrjepgwbwnjxjepthee
ilped	mdrnhepgadwnjtheptlge
ilpme	mdrfgepgiewnjlgeptthe
ilpyd	mdrthepgudwnjzheptfge
ilqed	mdqnhephadwnithepulge
ilqme	mdqfgephiewnilgeputhe
ilqyd	mdqthephudwnizhepufge
ilred	mdpnhepiadwnhthepvlge
ilrme	mdpfgepiiewnhlgepvthe
ilryd	mdpthepiudwnhzhepvfge
ilsed	mdonhepjadwngthepwlge
ilsme	mdofgepjiewnglgepwthe
ilsyd	mdothepjudwngzhepwfge
ilted	mdnnhepkadwnfthepxlge
iltme	mdnfgepkiewnflgepxthe
iltyd	mdnthepkudwnfzhepxfge
ilued	mdmnhepladwnethepylge
ilume	mdmfgepliewnelgepythe
iluyd	mdmthepludwnezhepyfge
ilved	mdlnhepmadwndthepzlge
ilvme	mdlfgepmiewndlgepzthe
ilvyd	mdlthepmudwndzhepzfge
ilwed	mdknhepnadwncthepalge
ilwme	mdkfgepniewnclgepathe
ilwyd	mdkthepnudwnczhepafge
ilxed	mdjnhepoadwnbthepblge
ilxme	mdjfgepoiewnblgepbthe
ilxyd	mdjthepoudwnbzhepbfge
ilyed	mdinheppadwnathepclge
ilyme	mdifgeppiewnalgepcthe
ilyyd	mditheppudwnazhepcfge
ilzed	mdhnhepqadwnzthepdlge
ilzme	mdhfgepqiewnzlgepdthe
ilzyd	mdhthepqudwnzzhepdfge
imaed	mcgnheqradwmytheqelge
imame	mcgfgeqriewmylgeqethe
imayd	mcgtheqrudwmyzheqefge
imbed	mcfnheqsadwmxtheqflge
imbme	mcffgeqsiewmxlgeqfthe
imbyd	mcftheqsudwmxzheqffge
imced	mcenheqtadwmwtheqglge
imcle	mceggeqthewmwmgeqgshe
imcme	mcefgeqtiewmwlgeqgthe
imcyd	mcetheqtudwmwzheqgfge
imded	mcdnhequadwmvtheqhlge
imdme	mcdfgequiewmvlgeqhthe
imdyd	mcdthequudwmvzheqhfge
imeed	mccnheqvadwmutheqilge
imeme	mccfgeqviewmulgeqithe
imeyd	mcctheqvudwmuzheqifge
imfed	mcbnheqwadwmttheqjlge
imfme	mcbfgeqwiewmtlgeqjthe
imfqg	mcbbeeqwmgwmtheeqjxje
imfyd	mcbtheqwudwmtzheqjfge
imged	mcanheqxadwmstheqklge
imgme	mcafgeqxiewmslgeqkthe
imgyd	mcatheqxudwmszheqkfge
imhed	mcznheqyadwmrtheqllge
imhme	mczfgeqyiewmrlgeqlthe
imhyd	mcztheqyudwmrzheqlfge
imied	mcynheqzadwmqtheqmlge
imime	mcyfgeqziewmqlgeqmthe
imiyd	mcytheqzudwmqzheqmfge
imjed	mcxnheqaadwmptheqnlge
imjme	mcxfgeqaiewmplgeqnthe
imjyd	mcxtheqaudwmpzheqnfge
imked	mcwnheqbadwmotheqolge
imkme	mcwfgeqbiewmolgeqothe
imkyd	mcwtheqbudwmozheqofge
imled	mcvnheqcadwmntheqplge
imlme	mcvfgeqciewmnlgeqpthe
imlyd	mcvtheqcudwmnzheqpfge
immed	mcunheqdadwmmtheqqlge
immme	mcufgeqdiewmmlgeqqthe
immyd	mcutheqdudwmmzheqqfge
imned	mctnheqeadwmltheqrlge
imnkg	mctheeqeggwmlneeqrrje
imnme	mctfgeqeiewmllgeqrthe
imnyd	mcttheqeudwmlzheqrfge
imoed	mcsnheqfadwmktheqslge
imome	mcsfgeqfiewmklgeqsthe
imoyd	mcstheqfudwmkzheqsfge
impab	mcrrjeqgwbwmjxjeqthee
imped	mcrnheqgadwmjtheqtlge
impme	mcrfgeqgiewmjlgeqtthe
impyd	mcrtheqgudwmjzheqtfge
imqed	mcqnheqhadwmithequlge
imqme	mcqfgeqhiewmilgequthe
imqyd	mcqtheqhudwmizhequfge
imred	mcpnheqiadwmhtheqvlge
imrme	mcpfgeqiiewmhlgeqvthe
imryd	mcptheqiudwmhzheqvfge
imsed	mconheqjadwmgtheqwlge
imsme	mcofgeqjiewmglgeqwthe
imsyd	mcotheqjudwmgzheqwfge
imted	mcnnheqkadwmftheqxlge
imtme	mcnfgeqkiewmflgeqxthe
imtyd	mcntheqkudwmfzheqxfge
imued	mcmnheqladwmetheqylge
imume	mcmfgeqliewmelgeqythe
imuyd	mcmtheqludwmezheqyfge
imved	mclnheqmadwmdtheqzlge
imvme	mclfgeqmiewmdlgeqzthe
imvyd	mcltheqmudwmdzheqzfge
imwed	mcknheqnadwmctheqalge
imwme	mckfgeqniewmclgeqathe
imwyd	mcktheqnudwmczheqafge
imxed	mcjnheqoadwmbtheqblge
imxme	mcjfgeqoiewmblgeqbthe
imxyd	mcjtheqoudwmbzheqbfge
imyed	mcinheqpadwmatheqclge
imyme	mcifgeqpiewmalgeqcthe
imyyd	mcitheqpudwmazheqcfge
imzed	mchnheqqadwmztheqdlge
imzme	mchfgeqqiewmzlgeqdthe
imzyd	mchtheqqudwmzzheqdfge
inaed	mbgnherradwlytherelge
iname	mbgfgerriewlylgerethe
inayd	mbgtherrudwlyzherefge
inbed	mbfnhersadwlxtherflge
inbme	mbffgersiewlxlgerfthe
inbyd	mbfthersudwlxzherffge
inced	mbenhertadwlwtherglge
incle	mbeggerthewlwmgergshe
incme	mbefgertiewlwlgergthe
incyd	mbethertudwlwzhergfge
inded	mbdnheruadwlvtherhlge
indme	mbdfgeruiewlvlgerhthe
indyd	mbdtheruudwlvzherhfge
ineed	mbcnhervadwlutherilge
ineme	mbcfgerviewlulgerithe
ineyd	mbcthervudwluzherifge
infed	mbbnherwadwlttherjlge
infme	mbbfgerwiewltlgerjthe
infqg	mbbbeerwmgwltheerjxje
infyd	mbbtherwudwltzherjfge
inged	mbanherxadwlstherklge
ingme	mbafgerxiewlslgerkthe
ingyd	mbatherxudwlszherkfge
inhed	mbznheryadwlrtherllge
inhme	mbzfgeryiewlrlgerlthe
inhyd	mbztheryudwlrzherlfge
inied	mbynherzadwlqthermlge
inime	mbyfgerziewlqlgermthe
iniyd	mbytherzudwlqzhermfge
injed	mbxnheraadwlpthernlge
injme	mbxfgeraiewlplgernthe
injyd	mbxtheraudwlpzhernfge
inked	mbwnherbadwlotherolge
inkme	mbwfgerbiewlolgerothe
inkyd	mbwtherbudwlozherofge
inled	mbvnhercadwlntherplge
inlme	mbvfgerciewlnlgerpthe
inlyd	mbvthercudwlnzherpfge
inmed	mbunherdadwlmtherqlge
inmme	mbufgerdiewlmlgerqthe
inmyd	mbutherdudwlmzherqfge
inned	mbtnhereadwlltherrlge
innkg	mbtheereggwllneerrrje
innme	mbtfgereiewlllgerrthe
innyd	mbtthereudwllzherrfge
inoed	mbsnherfadwlktherslge
inome	mbsfgerfiewlklgersthe
inoyd	mbstherfudwlkzhersfge
inpab	mbrrjergwbwljxjerthee
inped	mbrnhergadwljthertlge
inpme	mbrfgergiewljlgertthe
inpyd	mbrthergudwljzhertfge
inqed	mbqnherhadwlitherulge
inqme	mbqfgerhiewlilgeruthe
inqyd	mbqtherhudwlizherufge
inred	mbpnheriadwlhthervlge
inrme	mbpfgeriiewlhlgervthe
inryd	mbptheriudwlhzhervfge
insed	mbonherjadwlgtherwlge
insme	mbofgerjiewlglgerwthe
insyd	mbotherjudwlgzherwfge
inted	mbnnherkadwlftherxlge
intme	mbnfgerkiewlflgerxthe
intyd	mbntherkudwlfzherxfge
inued	mbmnherladwletherylge
inume	mbmfgerliewlelgerythe
inuyd	mbmtherludwlezheryfge
inved	mblnhermadwldtherzlge
invme	mblfgermiewldlgerzthe
invyd	mblthermudwldzherzfge
inwed	mbknhernadwlctheralge
inwme	mbkfgerniewlclgerathe
inwyd	mbkthernudwlczherafge
inxed	mbjnheroadwlbtherblge
inxme	mbjfgeroiewlblgerbthe
inxyd	mbjtheroudwlbzherbfge
inyed	mbinherpadwlatherclge
inyme	mbifgerpiewlalgercthe
inyyd	mbitherpudwlazhercfge
inzed	mbhnherqadwlztherdlge
inzme	mbhfgerqiewlzlgerdthe
inzyd	mbhtherqudwlzzherdfge
ioaed	magnhesradwkytheselge
ioame	magfgesriewkylgesethe
ioayd	magthesrudwkyzhesefge
iobed	mafnhessadwkxthesflge
iobme	maffgessiewkxlgesfthe
iobyd	mafthessudwkxzhesffge
ioced	maenhestadwkwthesglge
iocle	maeggesthewkwmgesgshe
iocme	maefgestiewkwlgesgthe
iocyd	maethestudwkwzhesgfge
ioded	madnhesuadwkvtheshlge
iodme	madfgesuiewkvlgeshthe
iodyd	madthesuudwkvzheshfge
ioeed	macnhesvadwkuthesilge
ioeme	macfgesviewkulgesithe
ioeyd	macthesvudwkuzhesifge
iofed	mabnheswadwktthesjlge
iofme	mabfgeswiewktlgesjthe
iofqg	mabbeeswmgwktheesjxje
iofyd	mabtheswudwktzhesjfge
ioged	maanhesxadwksthesklge
iogme	maafgesxiewkslgeskthe
iogyd	maathesxudwkszheskfge
iohed	maznhesyadwkrthesllge
iohme	mazfgesyiewkrlgeslthe
iohyd	mazthesyudwkrzheslfge
ioied	maynheszadwkqthesmlge
ioime	mayfgesziewkqlgesmthe
ioiyd	maytheszudwkqzhesmfge
iojed	maxnhesaadwkpthesnlge
iojme	maxfgesaiewkplgesnthe
iojyd	maxthesaudwkpzhesnfge
ioked	mawnhesbadwkothesolge
iokme	mawfgesbiewkolgesothe
iokyd	mawthesbudwkozhesofge
ioled	mavnhescadwknthesplge
iolme	mavfgesciewknlgespthe
iolyd	mavthescudwknzhespfge
iomed	maunhesdadwkmthesqlge
iomme	maufgesdiewkmlgesqthe
iomyd	mauthesdudwkmzhesqfge
ioned	matnheseadwklthesrlge
ionkg	matheeseggwklneesrrje
ionme	matfgeseiewkllgesrthe
ionyd	mattheseudwklzhesrfge
iooed	masnhesfadwkkthesslge
ioome	masfgesfiewkklgessthe
iooyd	masthesfudwkkzhessfge
iopab	marrjesgwbwkjxjesthee
ioped	marnhesgadwkjthestlge
iopme	marfgesgiewkjlgestthe
iopyd	marthesgudwkjzhestfge
ioqed	maqnheshadwkithesulge
ioqme	maqfgeshiewkilgesuthe
ioqyd	maqtheshudwkizhesufge
iored	mapnhesiadwkhthesvlge
iorme	mapfgesiiewkhlgesvthe
ioryd	mapthesiudwkhzhesvfge
iosed	maonhesjadwkgtheswlge
iosme	maofgesjiewkglgeswthe
iosyd	maothesjudwkgzheswfge
ioted	mannheskadwkfthesxlge
iotme	manfgeskiewkflgesxthe
iotyd	mantheskudwkfzhesxfge
ioued	mamnhesladwkethesylge
ioume	mamfgesliewkelgesythe
iouyd	mamthesludwkezhesyfge
ioved	malnhesmadwkdtheszlge
iovme	malfgesmiewkdlgeszthe
iovyd	malthesmudwkdzheszfge
iowed	maknhesnadwkcthesalge
iowme	makfgesniewkclgesathe
iowyd	makthesnudwkczhesafge
ioxed	majnhesoadwkbthesblge
ioxme	majfgesoiewkblgesbthe
ioxyd	majthesoudwkbzhesbfge
ioyed	mainhespadwkathesclge
ioyme	maifgespiewkalgescthe
ioyyd	maithespudwkazhescfge
iozed	mahnhesqadwkzthesdlge
iozme	mahfgesqiewkzlgesdthe
iozyd	mahthesqudwkzzhesdfge
ipaed	mzgnhetradwjythetelge
ipame	mzgfgetriewjylgetethe
ipayd	mzgthetrudwjyzhetefge
ipbed	mzfnhetsadwjxthetflge
ipbme	mzffgetsiewjxlgetfthe
ipbyd	mzfthetsudwjxzhetffge
ipced	mzenhettadwjwthetglge
ipcle	mzeggetthewjwmgetgshe
ipcme	mzefgettiewjwlgetgthe
ipcyd	mzethettudwjwzhetgfge
ipded	mzdnhetuadwjvthethlge
ipdme	mzdfgetuiewjvlgeththe
ipdxa	mzduketutawjvakethede
ipdyd	mzdthetuudwjvzhethfge
ipeed	mzcnhetvadwjuthetilge
ipeme	mzcfgetviewjulgetithe
ipeyd	mzcthetvudwjuzhetifge
ipfed	mzbnhetwadwjtthetjlge
ipfme	mzbfgetwiewjtlgetjthe
ipfqg	mzbbeetwmgwjtheetjxje
ipfyd	mzbthetwudwjtzhetjfge
ipged	mzanhetxadwjsthetklge
ipgme	mzafgetxiewjslgetkthe
ipgyd	mzathetxudwjszhetkfge
iphed	mzznhetyadwjrthetllge
iphme	mzzfgetyiewjrlgetlthe
iphyd	mzzthetyudwjrzhetlfge
ipied	mzynhetzadwjqthetmlge
ipime	mzyfgetziewjqlgetmthe
ipiyd	mzythetzudwjqzhetmfge
ipjed	mzxnhetaadwjpthetnlge
ipjme	mzxfgetaiewjplgetnthe
ipjyd	mzxthetaudwjpzhetnfge
ipked	mzwnhetbadwjothetolge
ipkme	mzwfgetbiewjolgetothe
ipkyd	mzwthetbudwjozhetofge
ipled	mzvnhetcadwjnthetplge
iplme	mzvfgetciewjnlgetpthe
iplyd	mzvthetcudwjnzhetpfge
ipmed	mzunhetdadwjmthetqlge
ipmme	mzufgetdiewjmlgetqthe
ipmyd	mzuthetdudwjmzhetqfge
ipned	mztnheteadwjlthetrlge
ipnkg	mztheeteggwjlneetrrje
ipnme	mztfgeteiewjllgetrthe
ipnyd	mzttheteudwjlzhetrfge
ipoed	mzsnhetfadwjkthetslge
ipome	mzsfgetfiewjklgetsthe
ipoyd	mzsthetfudwjkzhetsfge
ippab	mzrrjetgwbwjjxjetthee
ipped	mzrnhetgadwjjthettlge
ippme	mzrfgetgiewjjlgettthe
ippyd	mzrthetgudwjjzhettfge
ipqed	mzqnhethadwjithetulge
ipqia	mzqjketheawjipketupde
ipqme	mzqfgethiewjilgetuthe
ipqyd	mzqthethudwjizhetufge
ipred	mzpnhetiadwjhthetvlge
iprme	mzpfgetiiewjhlgetvthe
ipryd	mzpthetiudwjhzhetvfge
ipsed	mzonhetjadwjgthetwlge
ipsme	mzofgetjiewjglgetwthe
ipsyd	mzothetjudwjgzhetwfge
ipted	mznnhetkadwjfthetxlge
iptme	mznfgetkiewjflgetxthe
iptyd	mznthetkudwjfzhetxfge
ipued	mzmnhetladwjethetylge
ipume	mzmfgetliewjelgetythe
ipuyd	mzmthetludwjezhetyfge
ipved	mzlnhetmadwjdthetzlge
ipvme	mzlfgetmiewjdlgetzthe
ipvyd	mzlthetmudwjdzhetzfge
ipwed	mzknhetnadwjcthetalge
ipwme	mzkfgetniewjclgetathe
ipwyd	mzkthetnudwjczhetafge
ipxed	mzjnhetoadwjbthetblge
ipxme	mzjfgetoiewjblgetbthe
ipxyd	mzjthetoudwjbzhetbfge
ipyed	mzinhetpadwjathetclge
ipyme	mzifgetpiewjalgetcthe
ipyyd	mzithetpudwjazhetcfge
ipzed	mzhnhetqadwjzthetdlge
ipzme	mzhfgetqiewjzlgetdthe
ipzyd	mzhthetqudwjzzhetdfge
iqaed	mygnheuradwiytheuelge
iqame	mygfgeuriewiylgeuethe
iqayd	mygtheurudwiyzheuefge
iqbed	myfnheusadwixtheuflge
iqbme	myffgeusiewixlgeufthe
iqbyd	myftheusudwixzheuffge
iqced	myenheutadwiwtheuglge
iqcle	myeggeuthewiwmgeugshe
iqcme	myefgeutiewiwlgeugthe
iqcyd	myetheutudwiwzheugfge
iqded	mydnheuuadwivtheuhlge
iqdme	mydfgeuuiewivlgeuhthe
iqdyd	mydtheuuudwivzheuhfge
iqeed	mycnheuvadwiutheuilge
iqeme	mycfgeuviewiulgeuithe
iqeyd	myctheuvudwiuzheuifge
iqfed	mybnheuwadwittheujlge
iqfme	mybfgeuwiewitlgeujthe
iqfqg	mybbeeuwmgwitheeujxje
iqfyd	mybtheuwudwitzheujfge
iqged	myanheuxadwistheuklge
iqgme	myafgeuxiewislgeukthe
iqgyd	myatheuxudwiszheukfge
iqhed	myznheuyadwirtheullge
iqhme	myzfgeuyiewirlgeulthe
iqhyd	myztheuyudwirzheulfge
iqied	myynheuzadwiqtheumlge
iqime	myyfgeuziewiqlgeumthe
iqiyd	myytheuzudwiqzheumfge
iqjed	myxnheuaadwiptheunlge
iqjme	myxfgeuaiewiplgeunthe
iqjyd	myxtheuaudwipzheunfge
iqked	mywnheubadwiotheuolge
iqkme	mywfgeubiewiolgeuothe
iqkyd	mywtheubudwiozheuofge
iqled	myvnheucadwintheuplge
iqlme	myvfgeuciewinlgeupthe
iqlyd	myvtheucudwinzheupfge
iqmed	myunheudadwimtheuqlge
iqmme	myufgeudiewimlgeuqthe
iqmyd	myutheududwimzheuqfge
iqned	mytnheueadwiltheurlge
iqnkg	mytheeueggwilneeurrje
iqnme	mytfgeueiewillgeurthe
iqnyd	myttheueudwilzheurfge
iqoed	mysnheufadwiktheuslge
iqome	mysfgeufiewiklgeusthe
iqoyd	mystheufudwikzheusfge
iqpab	myrrjeugwbwijxjeuthee
iqped	myrnheugadwijtheutlge
iqpme	myrfgeugiewijlgeutthe
iqpyd	myrtheugudwijzheutfge
iqqed	myqnheuhadwiitheuulge
iqqme	myqfgeuhiewiilgeuuthe
iqqyd	myqtheuhudwiizheuufge
iqred	mypnheuiadwihtheuvlge
iqrme	mypfgeuiiewihlgeuvthe
iqryd	myptheuiudwihzheuvfge
iqsed	myonheujadwigtheuwlge
iqsme	myofgeujiewiglgeuwthe
iqsyd	myotheujudwigzheuwfge
iqted	mynnheukadwiftheuxlge
iqtme	mynfgeukiewiflgeuxthe
iqtyd	myntheukudwifzheuxfge
iqued	mymnheuladwietheuylge
iqume	mymfgeuliewielgeuythe
iquyd	mymtheuludwiezheuyfge
iqved	mylnheumadwidtheuzlge
iqvme	mylfgeumiewidlgeuzthe
iqvyd	myltheumudwidzheuzfge
iqwed	myknheunadwictheualge
iqwme	mykfgeuniewiclgeuathe
iqwyd	myktheunudwiczheuafge
iqxed	myjnheuoadwibtheublge
iqxme	myjfgeuoiewiblgeubthe
iqxyd	myjtheuoudwibzheubfge
iqyed	myinheupadwiatheuclge
iqyme	myifgeupiewialgeucthe
iqyyd	myitheupudwiazheucfge
iqzed	myhnheuqadwiztheudlge
iqzme	myhfgeuqiewizlgeudthe
iqzyd	myhtheuqudwizzheudfge
iraed	mxgnhevradwhythevelge
irame	mxgfgevriewhylgevethe
irayd	mxgthevrudwhyzhevefge
irbed	mxfnhevsadwhxthevflge
irbme	mxffgevsiewhxlgevfthe
irbyd	mxfthevsudwhxzhevffge
irced	mxenhevtadwhwthevglge
ircle	mxeggevthewhwmgevgshe
ircme	mxefgevtiewhwlgevgthe
ircyd	mxethevtudwhwzhevgfge
irded	mxdnhevuadwhvthevhlge
irdme	mxdfgevuiewhvlgevhthe
irdyd	mxdthevuudwhvzhevhfge
ireed	mxcnhevvadwhuthevilge
ireme	mxcfgevviewhulgevithe
ireyd	mxcthevvudwhuzhevifge
irfed	mxbnhevwadwhtthevjlge
irfme	mxbfgevwiewhtlgevjthe
irfqg	mxbbeevwmgwhtheevjxje
irfyd	mxbthevwudwhtzhevjfge
irged	mxanhevxadwhsthevklge
irgme	mxafgevxiewhslgevkthe
irgyd	mxathevxudwhszhevkfge
irhed	mxznhevyadwhrthevllge
irhme	mxzfgevyiewhrlgevlthe
irhyd	mxzthevyudwhrzhevlfge
iried	mxynhevzadwhqthevmlge
irime	mxyfgevziewhqlgevmthe
iriyd	mxythevzudwhqzhevmfge
irjed	mxxnhevaadwhpthevnlge
irjme	mxxfgevaiewhplgevnthe
irjyd	mxxthevaudwhpzhevnfge
irked	mxwnhevbadwhothevolge
irkme	mxwfgevbiewholgevothe
irkyd	mxwthevbudwhozhevofge
irled	mxvnhevcadwhnthevplge
irlme	mxvfgevciewhnlgevpthe
irlyd	mxvthevcudwhnzhevpfge
irmed	mxunhevdadwhmthevqlge
irmme	mxufgevdiewhmlgevqthe
irmyd	mxuthevdudwhmzhevqfge
irned	mxtnheveadwhlthevrlge
irnkg	mxtheeveggwhlneevrrje
irnme	mxtfgeveiewhllgevrthe
irnyd	mxttheveudwhlzhevrfge
iroed	mxsnhevfadwhkthevslge
irome	mxsfgevfiewhklgevsthe
iroyd	mxsthevfudwhkzhevsfge
irpab	mxrrjevgwbwhjxjevthee
irped	mxrnhevgadwhjthevtlge
irpme	mxrfgevgiewhjlgevtthe
irpyd	mxrthevgudwhjzhevtfge
irqed	mxqnhevhadwhithevulge
irqme	mxqfgevhiewhilgevuthe
irqyd	mxqthevhudwhizhevufge
irred	mxpnheviadwhhthevvlge
irrme	mxpfgeviiewhhlgevvthe
irryd	mxptheviudwhhzhevvfge
irsed	mxonhevjadwhgthevwlge
irsme	mxofgevjiewhglgevwthe
irsyd	mxothevjudwhgzhevwfge
irted	mxnnhevkadwhfthevxlge
irtme	mxnfgevkiewhflgevxthe
irtyd	mxnthevkudwhfzhevxfge
irued	mxmnhevladwhethevylge
irume	mxmfgevliewhelgevythe
iruyd	mxmthevludwhezhevyfge
irved	mxlnhevmadwhdthevzlge
irvme	mxlfgevmiewhdlgevzthe
irvyd	mxlthevmudwhdzhevzfge
irwed	mxknhevnadwhcthevalge
irwme	mxkfgevniewhclgevathe
irwyd	mxkthevnudwhczhevafge
irxed	mxjnhevoadwhbthevblge
irxme	mxjfgevoiewhblgevbthe
irxyd	mxjthevoudwhbzhevbfge
iryed	mxinhevpadwhathevclge
iryme	mxifgevpiewhalgevcthe
iryyd	mxithevpudwhazhevcfge
irzed	mxhnhevqadwhzthevdlge
irzme	mxhfgevqiewhzlgevdthe
irzyd	mxhthevqudwhzzhevdfge
isaed	mwgnhewradwgythewelge
isame	mwgfgewriewgylgewethe
isayd	mwgthewrudwgyzhewefge
isbed	mwfnhewsadwgxthewflge
isbme	mwffgewsiewgxlgewfthe
isbyd	mwfthewsudwgxzhewffge
isced	mwenhewtadwgwthewglge
iscle	mweggewthewgwmgewgshe
iscme	mwefgewtiewgwlgewgthe
iscyd	mwethewtudwgwzhewgfge
isded	mwdnhewuadwgvthewhlge
isdme	mwdfgewuiewgvlgewhthe
isdyd	mwdthewuudwgvzhewhfge
iseed	mwcnhewvadwguthewilge
iseme	mwcfgewviewgulgewithe
iseyd	mwcthewvudwguzhewifge
isfed	mwbnhewwadwgtthewjlge
isfme	mwbfgewwiewgtlgewjthe
isfqg	mwbbeewwmgwgtheewjxje
isfyd	mwbthewwudwgtzhewjfge
isged	mwanhewxadwgsthewklge
isgme	mwafgewxiewgslgewkthe
isgyd	mwathewxudwgszhewkfge
ished	mwznhewyadwgrthewllge
ishme	mwzfgewyiewgrlgewlthe
ishyd	mwzthewyudwgrzhewlfge
isied	mwynhewzadwgqthewmlge
isime	mwyfgewziewgqlgewmthe
isiyd	mwythewzudwgqzhewmfge
isjed	mwxnhewaadwgpthewnlge
isjme	mwxfgewaiewgplgewnthe
isjyd	mwxthewaudwgpzhewnfge
isked	mwwnhewbadwgothewolge
iskme	mwwfgewbiewgolgewothe
iskyd	mwwthewbudwgozhewofge
isled	mwvnhewcadwgnthewplge
islme	mwvfgewciewgnlgewpthe
islyd	mwvthewcudwgnzhewpfge
ismed	mwunhewdadwgmthewqlge
ismme	mwufgewdiewgmlgewqthe
ismyd	mwuthewdudwgmzhewqfge
isned	mwtnheweadwglthewrlge
isnkg	mwtheeweggwglneewrrje
isnme	mwtfgeweiewgllgewrthe
isnyd	mwttheweudwglzhewrfge
isoed	mwsnhewfadwgkthewslge
isome	mwsfgewfiewgklgewsthe
isoyd	mwsthewfudwgkzhewsfge
ispab	mwrrjewgwbwgjxjewthee
isped	mwrnhewgadwgjthewtlge
ispme	mwrfgewgiewgjlgewtthe
ispyd	mwrthewgudwgjzhewtfge
isqed	mwqnhewhadwgithewulge
isqme	mwqfgewhiewgilgewuthe
isqyd	mwqthewhudwgizhewufge
isred	mwpnhewiadwghthewvlge
isrme	mwpfgewiiewghlgewvthe
isryd	mwpthewiudwghzhewvfge
issed	mwonhewjadwggthewwlge
issme	mwofgewjiewgglgewwthe
issyd	mwothewjudwggzhewwfge
isted	mwnnhewkadwgfthewxlge
istme	mwnfgewkiewgflgewxthe
istyd	mwnthewkudwgfzhewxfge
isued	mwmnhewladwgethewylge
isume	mwmfgewliewgelgewythe
isuyd	mwmthewludwgezhewyfge
isved	mwlnhewmadwgdthewzlge
isvme	mwlfgewmiewgdlgewzthe
isvyd	mwlthewmudwgdzhewzfge
iswed	mwknhewnadwgcthewalge
iswme	mwkfgewniewgclgewathe
iswyd	mwkthewnudwgczhewafge
isxed	mwjnhewoadwgbthewblge
isxme	mwjfgewoiewgblgewbthe
isxyd	mwjthewoudwgbzhewbfge
isyed	mwinhewpadwgathewclge
isyme	mwifgewpiewgalgewcthe
isyyd	mwithewpudwgazhewcfge
iszed	mwhnhewqadwgzthewdlge
iszme	mwhfgewqiewgzlgewdthe
iszyd	mwhthewqudwgzzhewdfge
itaed	mvgnhexradwfythexelge
itame	mvgfgexriewfylgexethe
itayd	mvgthexrudwfyzhexefge
itbed	mvfnhexsadwfxthexflge
itbme	mvffgexsiewfxlgexfthe
itbyd	mvfthexsudwfxzhexffge
itced	mvenhextadwfwthexglge
itcle	mveggexthewfwmgexgshe
itcme	mvefgextiewfwlgexgthe
itcyd	mvethextudwfwzhexgfge
itded	mvdnhexuadwfvthexhlge
itdme	mvdfgexuiewfvlgexhthe
itdyd	mvdthexuudwfvzhexhfge
iteed	mvcnhexvadwfuthexilge
iteme	mvcfgexviewfulgexithe
iteyd	mvcthexvudwfuzhexifge
itfed	mvbnhexwadwftthexjlge
itfme	mvbfgexwiewftlgexjthe
itfqg	mvbbeexwmgwftheexjxje
itfyd	mvbthexwudwftzhexjfge
itged	mvanhexxadwfsthexklge
itgme	mvafgexxiewfslgexkthe
itgyd	mvathexxudwfszhexkfge
ithed	mvznhexyadwfrthexllge
ithme	mvzfgexyiewfrlgexlthe
ithyd	mvzthexyudwfrzhexlfge
itied	mvynhexzadwfqthexmlge
itime	mvyfgexziewfqlgexmthe
itiyd	mvythexzudwfqzhexmfge
itjed	mvxnhexaadwfpthexnlge
itjme	mvxfgexaiewfplgexnthe
itjyd	mvxthexaudwfpzhexnfge
itked	mvwnhexbadwfothexolge
itkme	mvwfgexbiewfolgexothe
itkyd	mvwthexbudwfozhexofge
itled	mvvnhexcadwfnthexplge
itlme	mvvfgexciewfnlgexpthe
itlyd	mvvthexcudwfnzhexpfge
itmed	mvunhexdadwfmthexqlge
itmme	mvufgexdiewfmlgexqthe
itmyd	mvuthexdudwfmzhexqfge
itned	mvtnhexeadwflthexrlge
itnkg	mvtheexeggwflneexrrje
itnme	mvtfgexeiewfllgexrthe
itnyd	mvtthexeudwflzhexrfge
itoed	mvsnhexfadwfkthexslge
itome	mvsfgexfiewfklgexsthe
itoyd	mvsthexfudwfkzhexsfge
itpab	mvrrjexgwbwfjxjexthee
itped	mvrnhexgadwfjthextlge
itpme	mvrfgexgiewfjlgextthe
itpyd	mvrthexgudwfjzhextfge
itqed	mvqnhexhadwfithexulge
itqme	mvqfgexhiewfilgexuthe
itqyd	mvqthexhudwfizhexufge
itred	mvpnhexiadwfhthexvlge
itrme	mvpfgexiiewfhlgexvthe
itryd	mvpthexiudwfhzhexvfge
itsed	mvonhexjadwfgthexwlge
itsme	mvofgexjiewfglgexwthe
itsyd	mvothexjudwfgzhexwfge
itted	mvnnhexkadwffthexxlge
ittme	mvnfgexkiewfflgexxthe
ittyd	mvnthexkudwffzhexxfge
itued	mvmnhexladwfethexylge
itume	mvmfgexliewfelgexythe
ituyd	mvmthexludwfezhexyfge
itved	mvlnhexmadwfdthexzlge
itvme	mvlfgexmiewfdlgexzthe
itvyd	mvlthexmudwfdzhexzfge
itwed	mvknhexnadwfcthexalge
itwme	mvkfgexniewfclgexathe
itwyd	mvkthexnudwfczhexafge
itxed	mvjnhexoadwfbthexblge
itxme	mvjfgexoiewfblgexbthe
itxyd	mvjthexoudwfbzhexbfge
ityed	mvinhexpadwfathexclge
ityme	mvifgexpiewfalgexcthe
ityyd	mvithexpudwfazhexcfge
itzed	mvhnhexqadwfzthexdlge
itzme	mvhfgexqiewfzlgexdthe
itzyd	mvhthexqudwfzzhexdfge
iuaed	mugnheyradweytheyelge
iuame	mugfgeyrieweylgeyethe
iuayd	mugtheyrudweyzheyefge
iubed	mufnheysadwextheyflge
iubme	muffgeysiewexlgeyfthe
iubyd	muftheysudwexzheyffge
iuced	muenheytadwewtheyglge
iucle	mueggeythewewmgeygshe
iucme	muefgeytiewewlgeygthe
iucyd	muetheytudwewzheygfge
iuded	mudnheyuadwevtheyhlge
iudme	mudfgeyuiewevlgeyhthe
iudyd	mudtheyuudwevzheyhfge
iueed	mucnheyvadweutheyilge
iueme	mucfgeyvieweulgeyithe
iueyd	muctheyvudweuzheyifge
iufed	mubnheywadwettheyjlge
iufme	mubfgeywiewetlgeyjthe
iufqg	mubbeeywmgwetheeyjxje
iufyd	mubtheywudwetzheyjfge
iuged	muanheyxadwestheyklge
iugme	muafgeyxieweslgeykthe
iugyd	muatheyxudweszheykfge
iuhed	muznheyyadwertheyllge
iuhme	muzfgeyyiewerlgeylthe
iuhyd	muztheyyudwerzheylfge
iuied	muynheyzadweqtheymlge
iuime	muyfgeyzieweqlgeymthe
iuiyd	muytheyzudweqzheymfge
iujed	muxnheyaadweptheynlge
iujme	muxfgeyaieweplgeynthe
iujyd	muxtheyaudwepzheynfge
iuked	muwnheybadweotheyolge
iukme	muwfgeybieweolgeyothe
iukyd	muwtheybudweozheyofge
iuled	muvnheycadwentheyplge
iulme	muvfgeyciewenlgeypthe
iulyd	muvtheycudwenzheypfge
iumed	muunheydadwemtheyqlge
iumme	muufgeydiewemlgeyqthe
iumyd	muutheydudwemzheyqfge
iuned	mutnheyeadweltheyrlge
iunkg	mutheeyeggwelneeyrrje
iunme	mutfgeyeiewellgeyrthe
iunyd	muttheyeudwelzheyrfge
iuoed	musnheyfadwektheyslge
iuome	musfgeyfieweklgeysthe
iuoyd	mustheyfudwekzheysfge
iupab	murrjeygwbwejxjeythee
iuped	murnheygadwejtheytlge
iupme	murfgeygiewejlgeytthe
iupyd	murtheygudwejzheytfge
iuqed	muqnheyhadweitheyulge
iuqme	muqfgeyhieweilgeyuthe
iuqyd	muqtheyhudweizheyufge
iured	mupnheyiadwehtheyvlge
iurme	mupfgeyiiewehlgeyvthe
iuryd	muptheyiudwehzheyvfge
iused	muonheyjadwegtheywlge
iusme	muofgeyjieweglgeywthe
iusyd	muotheyjudwegzheywfge
iuted	munnheykadweftheyxlge
iutme	munfgeykieweflgeyxthe
iutyd	muntheykudwefzheyxfge
iuued	mumnheyladweetheyylge
iuume	mumfgeylieweelgeyythe
iuuyd	mumtheyludweezheyyfge
iuved	mulnheymadwedtheyzlge
iuvme	mulfgeymiewedlgeyzthe
iuvyd	multheymudwedzheyzfge
iuwed	muknheynadwectheyalge
iuwme	mukfgeynieweclgeyathe
iuwyd	muktheynudweczheyafge
iuxed	mujnheyoadwebtheyblge
iuxme	mujfgeyoieweblgeybthe
iuxyd	mujtheyoudwebzheybfge
iuyed	muinheypadweatheyclge
iuyme	muifgeypiewealgeycthe
iuyyd	muitheypudweazheycfge
iuzed	muhnheyqadweztheydlge
iuzme	muhfgeyqiewezlgeydthe
iuzyd	muhtheyqudwezzheydfge
ivaed	mtgnhezradwdythezelge
ivame	mtgfgezriewdylgezethe
ivayd	mtgthezrudwdyzhezefge
ivbed	mtfnhezsadwdxthezflge
ivbme	mtffgezsiewdxlgezfthe
ivbyd	mtfthezsudwdxzhezffge
ivced	mtenheztadwdwthezglge
ivcle	mteggezthewdwmgezgshe
ivcme	mtefgeztiewdwlgezgthe
ivcyd	mtetheztudwdwzhezgfge
ivded	mtdnhezuadwdvthezhlge
ivdme	mtdfgezuiewdvlgezhthe
ivdyd	mtdthezuudwdvzhezhfge
iveed	mtcnhezvadwduthezilge
iveme	mtcfgezviewdulgezithe
iveyd	mtcthezvudwduzhezifge
ivfed	mtbnhezwadwdtthezjlge
ivfme	mtbfgezwiewdtlgezjthe
ivfqg	mtbbeezwmgwdtheezjxje
ivfyd	mtbthezwudwdtzhezjfge
ivged	mtanhezxadwdsthezklge
ivgme	mtafgezxiewdslgezkthe
ivgyd	mtathezxudwdszhezkfge
ivhed	mtznhezyadwdrthezllge
ivhme	mtzfgezyiewdrlgezlthe
ivhyd	mtzthezyudwdrzhezlfge
ivied	mtynhezzadwdqthezmlge
ivime	mtyfgezziewdqlgezmthe
iviyd	mtythezzudwdqzhezmfge
ivjed	mtxnhezaadwdptheznlge
ivjme	mtxfgezaiewdplgeznthe
ivjyd	mtxthezaudwdpzheznfge
ivked	mtwnhezbadwdothezolge
ivkme	mtwfgezbiewdolgezothe
ivkyd	mtwthezbudwdozhezofge
ivled	mtvnhezcadwdnthezplge
ivlme	mtvfgezciewdnlgezpthe
ivlyd	mtvthezcudwdnzhezpfge
ivmed	mtunhezdadwdmthezqlge
ivmme	mtufgezdiewdmlgezqthe
ivmyd	mtuthezdudwdmzhezqfge
ivned	mttnhezeadwdlthezrlge
ivnkg	mttheezeggwdlneezrrje
ivnme	mttfgezeiewdllgezrthe
ivnyd	mttthezeudwdlzhezrfge
ivoed	mtsnhezfadwdkthezslge
ivome	mtsfgezfiewdklgezsthe
ivoyd	mtsthezfudwdkzhezsfge
ivpab	mtrrjezgwbwdjxjezthee
ivped	mtrnhezgadwdjtheztlge
ivpme	mtrfgezgiewdjlgeztthe
ivpyd	mtrthezgudwdjzheztfge
ivqed	mtqnhezhadwdithezulge
ivqme	mtqfgezhiewdilgezuthe
ivqyd	mtqthezhudwdizhezufge
ivred	mtpnheziadwdhthezvlge
ivrme	mtpfgeziiewdhlgezvthe
ivryd	mtptheziudwdhzhezvfge
ivsed	mtonhezjadwdgthezwlge
ivsme	mtofgezjiewdglgezwthe
ivsyd	mtothezjudwdgzhezwfge
ivted	mtnnhezkadwdfthezxlge
ivtme	mtnfgezkiewdflgezxthe
ivtyd	mtnthezkudwdfzhezxfge
ivued	mtmnhezladwdethezylge
ivume	mtmfgezliewdelgezythe
ivuyd	mtmthezludwdezhezyfge
ivved	mtlnhezmadwddthezzlge
ivvme	mtlfgezmiewddlgezzthe
ivvyd	mtlthezmudwddzhezzfge
ivwed	mtknheznadwdcthezalge
ivwme	mtkfgezniewdclgezathe
ivwyd	mtktheznudwdczhezafge
ivxed	mtjnhezoadwdbthezblge
ivxme	mtjfgezoiewdblgezbthe
ivxyd	mtjthezoudwdbzhezbfge
ivyed	mtinhezpadwdathezclge
ivyme	mtifgezpiewdalgezcthe
ivyyd	mtithezpudwdazhezcfge
ivzed	mthnhezqadwdzthezdlge
ivzme	mthfgezqiewdzlgezdthe
ivzna	mthekezqjawdzkkezdude
ivzyd	mththezqudwdzzhezdfge
iwaed	msgnhearadwcytheaelge
iwame	msgfgeariewcylgeaethe
iwayd	msgthearudwcyzheaefge
iwbed	msfnheasadwcxtheaflge
iwbme	msffgeasiewcxlgeafthe
iwbyd	msftheasudwcxzheaffge
iwced	msenheatadwcwtheaglge
iwcle	mseggeathewcwmgeagshe
iwcme	msefgeatiewcwlgeagthe
iwcyd	msetheatudwcwzheagfge
iwded	msdnheauadwcvtheahlge
iwdme	msdfgeauiewcvlgeahthe
iwdyd	msdtheauudwcvzheahfge
iweed	mscnheavadwcutheailge
iweme	mscfgeaviewculgeaithe
iweyd	msctheavudwcuzheaifge
iwfed	msbnheawadwcttheajlge
iwfme	msbfgeawiewctlgeajthe
iwfqg	msbbeeawmgwctheeajxje
iwfyd	msbtheawudwctzheajfge
iwged	msanheaxadwcstheaklge
iwgme	msafgeaxiewcslgeakthe
iwgyd	msatheaxudwcszheakfge
iwhed	msznheayadwcrtheallge
iwhme	mszfgeayiewcrlgealthe
iwhyd	msztheayudwcrzhealfge
iwied	msynheazadwcqtheamlge
iwime	msyfgeaziewcqlgeamthe
iwiyd	msytheazudwcqzheamfge
iwjed	msxnheaaadwcptheanlge
iwjme	msxfgeaaiewcplgeanthe
iwjyd	msxtheaaudwcpzheanfge
iwked	mswnheabadwcotheaolge
iwkme	mswfgeabiewcolgeaothe
iwkyd	mswtheabudwcozheaofge
iwled	msvnheacadwcntheaplge
iwlme	msvfgeaciewcnlgeapthe
iwlyd	msvtheacudwcnzheapfge
iwmed	msunheadadwcmtheaqlge
iwmme	msufgeadiewcmlgeaqthe
iwmyd	msutheadudwcmzheaqfge
iwned	mstnheaeadwclthearlge
iwnkg	mstheeaeggwclneearrje
iwnme	mstfgeaeiewcllgearthe
iwnyd	msttheaeudwclzhearfge
iwoed	mssnheafadwcktheaslge
iwome	mssfgeafiewcklgeasthe
iwoyd	msstheafudwckzheasfge
iwpab	msrrjeagwbwcjxjeathee
iwped	msrnheagadwcjtheatlge
iwpme	msrfgeagiewcjlgeatthe
iwpyd	msrtheagudwcjzheatfge
iwqed	msqnheahadwcitheaulge
iwqme	msqfgeahiewcilgeauthe
iwqyd	msqtheahudwcizheaufge
iwred	mspnheaiadwchtheavlge
iwrme	mspfgeaiiewchlgeavthe
iwryd	msptheaiudwchzheavfge
iwsed	msonheajadwcgtheawlge
iwsme	msofgeajiewcglgeawthe
iwsyd	msotheajudwcgzheawfge
iwted	msnnheakadwcftheaxlge
iwtme	msnfgeakiewcflgeaxthe
iwtyd	msntheakudwcfzheaxfge
iwued	msmnhealadwcetheaylge
iwume	msmfgealiewcelgeaythe
iwuyd	msmthealudwcezheayfge
iwved	mslnheamadwcdtheazlge
iwvme	mslfgeamiewcdlgeazthe
iwvyd	msltheamudwcdzheazfge
iwwed	msknheanadwcctheaalge
iwwme	mskfgeaniewcclgeaathe
iwwyd	msktheanudwcczheaafge
iwxed	msjnheaoadwcbtheablge
iwxme	msjfgeaoiewcblgeabthe
iwxyd	msjtheaoudwcbzheabfge
iwyed	msinheapadwcatheaclge
iwyme	msifgeapiewcalgeacthe
iwyyd	msitheapudwcazheacfge
iwzed	mshnheaqadwcztheadlge
iwzme	mshfgeaqiewczlgeadthe
iwzyd	mshtheaqudwczzheadfge
ixaed	mrgnhebradwbythebelge
ixame	mrgfgebriewbylgebethe
ixayd	mrgthebrudwbyzhebefge
ixbed	mrfnhebsadwbxthebflge
ixbme	mrffgebsiewbxlgebfthe
ixbyd	mrfthebsudwbxzhebffge
ixced	mrenhebtadwbwthebglge
ixcle	mreggebthewbwmgebgshe
ixcme	mrefgebtiewbwlgebgthe
ixcyd	mrethebtudwbwzhebgfge
ixded	mrdnhebuadwbvthebhlge
ixdme	mrdfgebuiewbvlgebhthe
ixdyd	mrdthebuudwbvzhebhfge
ixeed	mrcnhebvadwbuthebilge
ixeme	mrcfgebviewbulgebithe
ixeyd	mrcthebvudwbuzhebifge
ixfed	mrbnhebwadwbtthebjlge
ixfme	mrbfgebwiewbtlgebjthe
ixfqg	mrbbeebwmgwbtheebjxje
ixfyd	mrbthebwudwbtzhebjfge
ixged	mranhebxadwbsthebklge
ixgme	mrafgebxiewbslgebkthe
ixgyd	mrathebxudwbszhebkfge
ixhed	mrznhebyadwbrthebllge
ixhme	mrzfgebyiewbrlgeblthe
ixhyd	mrzthebyudwbrzheblfge
ixied	mrynhebzadwbqthebmlge
ixime	mryfgebziewbqlgebmthe
ixiyd	mrythebzudwbqzhebmfge
ixjed	mrxnhebaadwbpthebnlge
ixjme	mrxfgebaiewbplgebnthe
ixjyd	mrxthebaudwbpzhebnfge
ixked	mrwnhebbadwbothebolge
ixkme	mrwfgebbiewbolgebothe
ixkyd	mrwthebbudwbozhebofge
ixled	mrvnhebcadwbnthebplge
ixlme	mrvfgebciewbnlgebpthe
ixlyd	mrvthebcudwbnzhebpfge
ixmed	mrunhebdadwbmthebqlge
ixmme	mrufgebdiewbmlgebqthe
ixmyd	mruthebdudwbmzhebqfge
ixned	mrtnhebeadwblthebrlge
ixnkg	mrtheebeggwblneebrrje
ixnme	mrtfgebeiewbllgebrthe
ixnyd	mrtthebeudwblzhebrfge
ixoed	mrsnhebfadwbkthebslge
ixome	mrsfgebfiewbklgebsthe
ixoyd	mrsthebfudwbkzhebsfge
ixpab	mrrrjebgwbwbjxjebthee
ixped	mrrnhebgadwbjthebtlge
ixpme	mrrfgebgiewbjlgebtthe
ixpyd	mrrthebgudwbjzhebtfge
ixqed	mrqnhebhadwbithebulge
ixqme	mrqfgebhiewbilgebuthe
ixqyd	mrqthebhudwbizhebufge
ixred	mrpnhebiadwbhthebvlge
ixrme	mrpfgebiiewbhlgebvthe
ixryd	mrpthebiudwbhzhebvfge
ixsed	mronhebjadwbgthebwlge
ixsme	mrofgebjiewbglgebwthe
ixsyd	mrothebjudwbgzhebwfge
ixted	mrnnhebkadwbfthebxlge
ixtme	mrnfgebkiewbflgebxthe
ixtyd	mrnthebkudwbfzhebxfge
ixued	mrmnhebladwbethebylge
ixume	mrmfgebliewbelgebythe
ixuyd	mrmthebludwbezhebyfge
ixved	mrlnhebmadwbdthebzlge
ixvme	mrlfgebmiewbdlgebzthe
ixvyd	mrlthebmudwbdzhebzfge
ixwed	mrknhebnadwbcthebalge
ixwme	mrkfgebniewbclgebathe
ixwyd	mrkthebnudwbczhebafge
ixxed	mrjnheboadwbbthebblge
ixxme	mrjfgeboiewbblgebbthe
ixxyd	mrjtheboudwbbzhebbfge
ixyed	mrinhebpadwbathebclge
ixyme	mrifgebpiewbalgebcthe
ixyyd	mrithebpudwbazhebcfge
ixzed	mrhnhebqadwbzthebdlge
ixzme	mrhfgebqiewbzlgebdthe
ixzyd	mrhthebqudwbzzhebdfge
iyaed	mqgnhecradwaythecelge
iyame	mqgfgecriewaylgecethe
iyayd	mqgthecrudwayzhecefge
iybed	mqfnhecsadwaxthecflge
iybme	mqffgecsiewaxlgecfthe
iybyd	mqfthecsudwaxzhecffge
iyced	mqenhectadwawthecglge
iycle	mqeggecthewawmgecgshe
iycme	mqefgectiewawlgecgthe
iycyd	mqethectudwawzhecgfge
iyded	mqdnhecuadwavthechlge
iydme	mqdfgecuiewavlgechthe
iydyd	mqdthecuudwavzhechfge
iyeed	mqcnhecvadwauthecilge
iyeme	mqcfgecviewaulgecithe
iyeyd	mqcthecvudwauzhecifge
iyfed	mqbnhecwadwatthecjlge
iyfme	mqbfgecwiewatlgecjthe
iyfqg	mqbbeecwmgwatheecjxje
iyfyd	mqbthecwudwatzhecjfge
iyged	mqanhecxadwasthecklge
iygme	mqafgecxiewaslgeckthe
iygyd	mqathecxudwaszheckfge
iyhed	mqznhecyadwarthecllge
iyhme	mqzfgecyiewarlgeclthe
iyhyd	mqzthecyudwarzheclfge
iyied	mqynheczadwaqthecmlge
iyime	mqyfgecziewaqlgecmthe
iyiyd	mqytheczudwaqzhecmfge
iyjed	mqxnhecaadwapthecnlge
iyjme	mqxfgecaiewaplgecnthe
iyjyd	mqxthecaudwapzhecnfge
iyked	mqwnhecbadwaothecolge
iykme	mqwfgecbiewaolgecothe
iykyd	mqwthecbudwaozhecofge
iyled	mqvnheccadwanthecplge
iylme	mqvfgecciewanlgecpthe
iylyd	mqvtheccudwanzhecpfge
iymed	mqunhecdadwamthecqlge
iymme	mqufgecdiewamlgecqthe
iymyd	mquthecdudwamzhecqfge
iyned	mqtnheceadwalthecrlge
iynkg	mqtheeceggwalneecrrje
iynme	mqtfgeceiewallgecrthe
iynyd	mqttheceudwalzhecrfge
iyoed	mqsnhecfadwakthecslge
iyome	mqsfgecfiewaklgecsthe
iyoyd	mqsthecfudwakzhecsfge
iypab	mqrrjecgwbwajxjecthee
iyped	mqrnhecgadwajthectlge
iypme	mqrfgecgiewajlgectthe
iypyd	mqrthecgudwajzhectfge
iyqed	mqqnhechadwaitheculge
iyqme	mqqfgechiewailgecuthe
iyqyd	mqqthechudwaizhecufge
iyred	mqpnheciadwahthecvlge
iyrme	mqpfgeciiewahlgecvthe
iyryd	mqptheciudwahzhecvfge
iysed	mqonhecjadwagthecwlge
iysme	mqofgecjiewaglgecwthe
iysyd	mqothecjudwagzhecwfge
iyted	mqnnheckadwafthecxlge
iytme	mqnfgeckiewaflgecxthe
iytyd	mqntheckudwafzhecxfge
iyued	mqmnhecladwaethecylge
iyume	mqmfgecliewaelgecythe
iyuyd	mqmthecludwaezhecyfge
iyved	mqlnhecmadwadtheczlge
iyvme	mqlfgecmiewadlgeczthe
iyvyd	mqlthecmudwadzheczfge
iywed	mqknhecnadwacthecalge
iywme	mqkfgecniewaclgecathe
iywyd	mqkthecnudwaczhecafge
iyxed	mqjnhecoadwabthecblge
iyxme	mqjfgecoiewablgecbthe
iyxyd	mqjthecoudwabzhecbfge
iyyed	mqinhecpadwaathecclge
iyyme	mqifgecpiewaalgeccthe
iyyyd	mqithecpudwaazheccfge
iyzed	mqhnhecqadwazthecdlge
iyzme	mqhfgecqiewazlgecdthe
iyzyd	mqhthecqudwazzhecdfge
izaed	mpgnhedradwzythedelge
izame	mpgfgedriewzylgedethe
izayd	mpgthedrudwzyzhedefge
izbed	mpfnhedsadwzxthedflge
izbme	mpffgedsiewzxlgedfthe
izbyd	mpfthedsudwzxzhedffge
izced	mpenhedtadwzwthedglge
izcle	mpeggedthewzwmgedgshe
izcme	mpefgedtiewzwlgedgthe
izcyd	mpethedtudwzwzhedgfge
izded	mpdnheduadwzvthedhlge
izdme	mpdfgeduiewzvlgedhthe
izdyd	mpdtheduudwzvzhedhfge
izeed	mpcnhedvadwzuthedilge
izeme	mpcfgedviewzulgedithe
izeyd	mpcthedvudwzuzhedifge
izfed	mpbnhedwadwztthedjlge
izfme	mpbfgedwiewztlgedjthe
izfqg	mpbbeedwmgwztheedjxje
izfyd	mpbthedwudwztzhedjfge
izged	mpanhedxadwzsthedklge
izgme	mpafgedxiewzslgedkthe
izgyd	mpathedxudwzszhedkfge
izhed	mpznhedyadwzrthedllge
izhme	mpzfgedyiewzrlgedlthe
izhyd	mpzthedyudwzrzhedlfge
izied	mpynhedzadwzqthedmlge
izime	mpyfgedziewzqlgedmthe
iziyd	mpythedzudwzqzhedmfge
izjed	mpxnhedaadwzpthednlge
izjme	mpxfgedaiewzplgednthe
izjyd	mpxthedaudwzpzhednfge
izked	mpwnhedbadwzothedolge
izkme	mpwfgedbiewzolgedothe
izkyd	mpwthedbudwzozhedofge
izled	mpvnhedcadwznthedplge
izlme	mpvfgedciewznlgedpthe
izlyd	mpvthedcudwznzhedpfge
izmed	mpunheddadwzmthedqlge
izmme	mpufgeddiewzmlgedqthe
izmyd	mputheddudwzmzhedqfge
izned	mptnhedeadwzlthedrlge
iznkg	mptheedeggwzlneedrrje
iznme	mptfgedeiewzllgedrthe
iznyd	mptthedeudwzlzhedrfge
izoed	mpsnhedfadwzkthedslge
izome	mpsfgedfiewzklgedsthe
izoyd	mpsthedfudwzkzhedsfge
izpab	mprrjedgwbwzjxjedthee
izped	mprnhedgadwzjthedtlge
izpme	mprfgedgiewzjlgedtthe
izpyd	mprthedgudwzjzhedtfge
izqed	mpqnhedhadwzithedulge
izqme	mpqfgedhiewzilgeduthe
izqyd	mpqthedhudwzizhedufge
izred	mppnhediadwzhthedvlge
izrme	mppfgediiewzhlgedvthe
izryd	mppthediudwzhzhedvfge
izsed	mponhedjadwzgthedwlge
izsme	mpofgedjiewzglgedwthe
izsyd	mpothedjudwzgzhedwfge
izted	mpnnhedkadwzfthedxlge
iztme	mpnfgedkiewzflgedxthe
iztyd	mpnthedkudwzfzhedxfge
izued	mpmnhedladwzethedylge
izume	mpmfgedliewzelgedythe
izuyd	mpmthedludwzezhedyfge
izved	mplnhedmadwzdthedzlge
izvme	mplfgedmiewzdlgedzthe
izvyd	mplthedmudwzdzhedzfge
izwed	mpknhednadwzcthedalge
izwme	mpkfgedniewzclgedathe
izwyd	mpkthednudwzczhedafge
izxed	mpjnhedoadwzbthedblge
izxme	mpjfgedoiewzblgedbthe
izxyd	mpjthedoudwzbzhedbfge
izyed	mpinhedpadwzathedclge
izyme	mpifgedpiewzalgedcthe
izyyd	mpithedpudwzazhedcfge
izzed	mphnhedqadwzztheddlge
izzme	mphfgedqiewzzlgeddthe
izzyd	mphthedqudwzzzheddfge
jacle	loeggfethevywmgfegshd
jafqg	lobbefewmgvythefejxjd
jankg	lothefeeggvylneferrjd
japab	lorrjfegwbvyjxjfethed
jbcle	lneggffthevxwmgffgshd
jbfqg	lnbbeffwmgvxtheffjxjd
jbnkg	lntheffeggvxlneffrrjd
jbpab	lnrrjffgwbvxjxjffthed
jccle	lmeggfgthevwwmgfggshd
jcfqg	lmbbefgwmgvwthefgjxjd
jcnkg	lmthefgeggvwlnefgrrjd
jcpab	lmrrjfggwbvwjxjfgthed
jdcle	lleggfhthevvwmgfhgshd
jdfqg	llbbefhwmgvvthefhjxjd
jdnkg	llthefheggvvlnefhrrjd
jdpab	llrrjfhgwbvvjxjfhthed
jecle	lkeggfithevuwmgfigshd
jefqg	lkbbefiwmgvuthefijxjd
jenkg	lkthefieggvulnefirrjd
jepab	lkrrjfigwbvujxjfithed
jfcle	ljeggfjthevtwmgfjgshd
jffqg	ljbbefjwmgvtthefjjxjd
jfnkg	ljthefjeggvtlnefjrrjd
jfpab	ljrrjfjgwbvtjxjfjthed
jfrta	ljpykfjipavthekfjvadd
jgcle	lieggfkthevswmgfkgshd
jgfqg	libbefkwmgvsthefkjxjd
jgnkg	lithefkeggvslnefkrrjd
jgpab	lirrjfkgwbvsjxjfkthed
jhcle	lheggflthevrwmgflgshd
jhfqg	lhbbeflwmgvrthefljxjd
jhnkg	lhthefleggvrlneflrrjd
jhpab	lhrrjflgwbvrjxjflthed
jicle	lgeggfmthevqwmgfmgshd
jifqg	lgbbefmwmgvqthefmjxjd
jinkg	lgthefmeggvqlnefmrrjd
jipab	lgrrjfmgwbvqjxjfmthed
jjcle	lfeggfnthevpwmgfngshd
jjfqg	lfbbefnwmgvpthefnjxjd
jjnkg	lfthefneggvplnefnrrjd
jjpab	lfrrjfngwbvpjxjfnthed
jkcle	leeggfothevowmgfogshd
jkfqg	lebbefowmgvothefojxjd
jknkg	lethefoeggvolneforrjd
jkpab	lerrjfogwbvojxjfothed
jlcle	ldeggfpthevnwmgfpgshd
jlfqg	ldbbefpwmgvnthefpjxjd
jlnkg	ldthefpeggvnlnefprrjd
jlpab	ldrrjfpgwbvnjxjfpthed
jmcle	lceggfqthevmwmgfqgshd
jmfqg	lcbbefqwmgvmthefqjxjd
jmnkg	lcthefqeggvmlnefqrrjd
jmpab	lcrrjfqgwbvmjxjfqthed
jncle	lbeggfrthevlwmgfrgshd
jnfqg	lbbbefrwmgvlthefrjxjd
jnnkg	lbthefreggvllnefrrrjd
jnpab	lbrrjfrgwbvljxjfrthed
jocle	laeggfsthevkwmgfsgshd
jofqg	labbefswmgvkthefsjxjd
jonkg	lathefseggvklnefsrrjd
jopab	larrjfsgwbvkjxjfsthed
jpcle	lzeggftthevjwmgftgshd
jpdxa	lzdukftutavjvakfthedd
jpfqg	lzbbeftwmgvjtheftjxjd
jpnkg	lzthefteggvjlneftrrjd
jppab	lzrrjftgwbvjjxjftthed
jpqia	lzqjkftheavjipkftupdd
jqcle	lyeggfutheviwmgfugshd
jqfqg	lybbefuwmgvithefujxjd
jqnkg	lythefueggvilnefurrjd
jqpab	lyrrjfugwbvijxjfuthed
jrcle	lxeggfvthevhwmgfvgshd
jrfqg	lxbbefvwmgvhthefvjxjd
jrnkg	lxthefveggvhlnefvrrjd
jrpab	lxrrjfvgwbvhjxjfvthed
jscle	lweggfwthevgwmgfwgshd
jsfqg	lwbbefwwmgvgthefwjxjd
jsnkg	lwthefweggvglnefwrrjd
jspab	lwrrjfwgwbvgjxjfwthed
jtcle	lveggfxthevfwmgfxgshd
jtfqg	lvbbefxwmgvfthefxjxjd
jtnkg	lvthefxeggvflnefxrrjd
jtpab	lvrrjfxgwbvfjxjfxthed
jucle	lueggfythevewmgfygshd
jufqg	lubbefywmgvethefyjxjd
junkg	luthefyeggvelnefyrrjd
jupab	lurrjfygwbvejxjfythed
jvcle	lteggfzthevdwmgfzgshd
jvfqg	ltbbefzwmgvdthefzjxjd
jvnkg	ltthefzeggvdlnefzrrjd
jvpab	ltrrjfzgwbvdjxjfzthed
jvzna	lthekfzqjavdzkkfzdudd
jwcle	lseggfathevcwmgfagshd
jwfqg	lsbbefawmgvcthefajxjd
jwnkg	lsthefaeggvclnefarrjd
jwpab	lsrrjfagwbvcjxjfathed
jxcle	lreggfbthevbwmgfbgshd
jxfqg	lrbbefbwmgvbthefbjxjd
jxnkg	lrthefbeggvblnefbrrjd
jxpab	lrrrjfbgwbvbjxjfbthed
jycle	lqeggfcthevawmgfcgshd
jyfqg	lqbbefcwmgvathefcjxjd
jynkg	lqthefceggvalnefcrrjd
jypab	lqrrjfcgwbvajxjfcthed
jzcle	lpeggfdthevzwmgfdgshd
jzfqg	lpbbefdwmgvzthefdjxjd
jznkg	lpthefdeggvzlnefdrrjd
jzpab	lprrjfdgwbvzjxjfdthed
kacle	koegggetheuywmggegshc
kafqg	kobbegewmguythegejxjc
kankg	kothegeegguylnegerrjc
kapab	korrjgegwbuyjxjgethec
kbcle	knegggftheuxwmggfgshc
kbfqg	knbbegfwmguxthegfjxjc
kbnkg	knthegfegguxlnegfrrjc
kbpab	knrrjgfgwbuxjxjgfthec
kccle	kmeggggtheuwwmggggshc
kcfqg	kmbbeggwmguwtheggjxjc
kcnkg	kmtheggegguwlneggrrjc
kcpab	kmrrjgggwbuwjxjggthec
kdcle	kleggghtheuvwmgghgshc
kdfqg	klbbeghwmguvtheghjxjc
kdnkg	kltheghegguvlneghrrjc
kdpab	klrrjghgwbuvjxjghthec
kecle	kkegggitheuuwmggigshc
kefqg	kkbbegiwmguuthegijxjc
kenkg	kkthegiegguulnegirrjc
kepab	kkrrjgigwbuujxjgithec
kfcle	kjegggjtheutwmggjgshc
kffqg	kjbbegjwmgutthegjjxjc
kfnkg	kjthegjeggutlnegjrrjc
kfpab	kjrrjgjgwbutjxjgjthec
kfrta	kjpykgjipauthekgjvadc
kgcle	kiegggktheuswmggkgshc
kgfqg	kibbegkwmgusthegkjxjc
kgnkg	kithegkegguslnegkrrjc
kgpab	kirrjgkgwbusjxjgkthec
khcle	khegggltheurwmgglgshc
khfqg	khbbeglwmgurthegljxjc
khnkg	khthegleggurlneglrrjc
khpab	khrrjglgwburjxjglthec
kicle	kgegggmtheuqwmggmgshc
kifqg	kgbbegmwmguqthegmjxjc
kinkg	kgthegmegguqlnegmrrjc
kipab	kgrrjgmgwbuqjxjgmthec
kjcle	kfegggntheupwmggngshc
kjfqg	kfbbegnwmgupthegnjxjc
kjnkg	kfthegnegguplnegnrrjc
kjpab	kfrrjgngwbupjxjgnthec
kkcle	keegggotheuowmggogshc
kkfqg	kebbegowmguothegojxjc
kknkg	kethegoegguolnegorrjc
kkpab	kerrjgogwbuojxjgothec
klcle	kdegggptheunwmggpgshc
klfqg	kdbbegpwmgunthegpjxjc
klnkg	kdthegpeggunlnegprrjc
klpab	kdrrjgpgwbunjxjgpthec
kmcle	kcegggqtheumwmggqgshc
kmfqg	kcbbegqwmgumthegqjxjc
kmnkg	kcthegqeggumlnegqrrjc
kmpab	kcrrjgqgwbumjxjgqthec
kncle	kbegggrtheulwmggrgshc
knfqg	kbbbegrwmgulthegrjxjc
knnkg	kbthegreggullnegrrrjc
knpab	kbrrjgrgwbuljxjgrthec
kocle	kaegggstheukwmggsgshc
kofqg	kabbegswmgukthegsjxjc
konkg	kathegsegguklnegsrrjc
kopab	karrjgsgwbukjxjgsthec
kpcle	kzegggttheujwmggtgshc
kpdxa	kzdukgtutaujvakgthedc
kpfqg	kzbbegtwmgujthegtjxjc
kpnkg	kzthegteggujlnegtrrjc
kppab	kzrrjgtgwbujjxjgtthec
kpqia	kzqjkgtheaujipkgtupdc
kqcle	kyegggutheuiwmggugshc
kqfqg	kybbeguwmguithegujxjc
kqnkg	kytheguegguilnegurrjc
kqpab	kyrrjgugwbuijxjguthec
krcle	kxegggvtheuhwmggvgshc
krfqg	kxbbegvwmguhthegvjxjc
krnkg	kxthegvegguhlnegvrrjc
krpab	kxrrjgvgwbuhjxjgvthec
kscle	kwegggwtheugwmggwgshc
ksfqg	kwbbegwwmgugthegwjxjc
ksnkg	kwthegwegguglnegwrrjc
kspab	kwrrjgwgwbugjxjgwthec
ktcle	kvegggxtheufwmggxgshc
ktfqg	kvbbegxwmgufthegxjxjc
ktnkg	kvthegxegguflnegxrrjc
ktpab	kvrrjgxgwbufjxjgxthec
kucle	kuegggytheuewmggygshc
kufqg	kubbegywmguethegyjxjc
kunkg	kuthegyegguelnegyrrjc
kupab	kurrjgygwbuejxjgythec
kvcle	ktegggztheudwmggzgshc
kvfqg	ktbbegzwmgudthegzjxjc
kvnkg	ktthegzeggudlnegzrrjc
kvpab	ktrrjgzgwbudjxjgzthec
kvzna	kthekgzqjaudzkkgzdudc
kwcle	ksegggatheucwmggagshc
kwfqg	ksbbegawmgucthegajxjc
kwnkg	ksthegaegguclnegarrjc
kwpab	ksrrjgagwbucjxjgathec
kxcle	kregggbtheubwmggbgshc
kxfqg	krbbegbwmgubthegbjxjc
kxnkg	krthegbeggublnegbrrjc
kxpab	krrrjgbgwbubjxjgbthec
kycle	kqegggctheuawmggcgshc
kyfqg	kqbbegcwmguathegcjxjc
kynkg	kqthegceggualnegcrrjc
kypab	kqrrjgcgwbuajxjgcthec
kzcle	kpegggdtheuzwmggdgshc
kzfqg	kpbbegdwmguzthegdjxjc
kznkg	kpthegdegguzlnegdrrjc
kzpab	kprrjgdgwbuzjxjgdthec
laaar	jogrtherwrtyyxtheehub
laabr	jogqtherxrtyywtheeiub
laacr	jogptheryrtyyvtheejub
laadr	jogotherzrtyyutheekub
laaer	jogntherartyyttheelub
laafr	jogmtherbrtyystheemub
laagr	joglthercrtyyrtheenub
laahr	jogktherdrtyyqtheeoub
laair	jogjtherertyyptheepub
laajr	jogitherfrtyyotheequb
laakr	joghthergrtyyntheerub
laalr	joggtherhrtyymtheesub
laamr	jogftherirtyyltheetub
laanr	jogetherjrtyyktheeuub
laaor	jogdtherkrtyyjtheevub
laapr	jogctherlrtyyitheewub
laaqr	jogbthermrtyyhtheexub
laarr	jogathernrtyygtheeyub
laasr	jogztherortyyftheezub
laatr	jogytherprtyyetheeaub
laaur	jogxtherqrtyydtheebub
laavr	jogwtherrrtyyctheecub
laawr	jogvthersrtyybtheedub
laaxr	joguthertrtyyatheeeub
laayr	jogttherurtyyztheefub
laazr	jogsthervrtyyytheegub
labar	jofrtheswrtyxxthefhub
labbr	jofqthesxrtyxwthefiub
labcr	jofpthesyrtyxvthefjub
labdr	jofotheszrtyxuthefkub
laber	jofnthesartyxttheflub
labfr	jofmthesbrtyxsthefmub
labgr	joflthescrtyxrthefnub
labhr	jofkthesdrtyxqthefoub
labir	jofjthesertyxpthefpub
labjr	jofithesfrtyxothefqub
labkr	jofhthesgrtyxnthefrub
lablr	jofgtheshrtyxmthefsub
labmr	joffthesirtyxltheftub
labnr	jofethesjrtyxkthefuub
labor	jofdtheskrtyxjthefvub
labpr	jofctheslrtyxithefwub
labqr	jofbthesmrtyxhthefxub
labrr	jofathesnrtyxgthefyub
labsr	jofzthesortyxfthefzub
labtr	jofythesprtyxethefaub
labur	jofxthesqrtyxdthefbub
labvr	jofwthesrrtyxcthefcub
labwr	jofvthessrtyxbthefdub
labxr	jofuthestrtyxathefeub
labyr	joftthesurtyxztheffub
labzr	jofsthesvrtyxythefgub
lacar	joerthetwrtywxtheghub
lacbr	joeqthetxrtywwthegiub
laccr	joepthetyrtywvthegjub
lacdr	joeothetzrtywuthegkub
lacer	joenthetartywttheglub
lacfr	joemthetbrtywsthegmub
lacgr	joelthetcrtywrthegnub
lachr	joekthetdrtywqthegoub
lacir	joejthetertywpthegpub
lacjr	joeithetfrtywothegqub
lackr	joehthetgrtywnthegrub
lacle	joegghethetywmghegshb
lacmr	joefthetirtywlthegtub
lacnr	joeethetjrtywktheguub
lacor	joedthetkrtywjthegvub
lacpr	joecthetlrtywithegwub
lacqr	joebthetmrtywhthegxub
lacrr	joeathetnrtywgthegyub
lacsr	joezthetortywfthegzub
lactr	joeythetprtywethegaub
lacur	joexthetqrtywdthegbub
lacvr	joewthetrrtywcthegcub
lacwr	joevthetsrtywbthegdub
lacxr	joeuthettrtywathegeub
lacyr	joettheturtywzthegfub
laczr	joesthetvrtywytheggub
ladar	jodrtheuwrtyvxthehhub
ladbr	jodqtheuxrtyvwthehiub
ladcr	jodptheuyrtyvvthehjub
laddr	jodotheuzrtyvuthehkub
lader	jodntheuartyvtthehlub
ladfr	jodmtheubrtyvsthehmub
ladgr	jodltheucrtyvrthehnub
ladhr	jodktheudrtyvqthehoub
ladir	jodjtheuertyvpthehpub
ladjr	joditheufrtyvothehqub
ladkr	jodhtheugrtyvnthehrub
ladlr	jodgtheuhrtyvmthehsub
ladmr	jodftheuirtyvlthehtub
ladnr	jodetheujrtyvkthehuub
lador	joddtheukrtyvjthehvub
ladpr	jodctheulrtyvithehwub
ladqr	jodbtheumrtyvhthehxub
ladrr	jodatheunrtyvgthehyub
ladsr	jodztheuortyvfthehzub
ladtr	jodytheuprtyvethehaub
ladur	jodxtheuqrtyvdthehbub
ladvr	jodwtheurrtyvcthehcub
ladwr	jodvtheusrtyvbthehdub
ladxr	jodutheutrtyvatheheub
ladyr	jodttheuurtyvzthehfub
ladzr	jodstheuvrtyvythehgub
laear	jocrthevwrtyuxtheihub
laebr	jocqthevxrtyuwtheiiub
laecr	jocpthevyrtyuvtheijub
laedr	jocothevzrtyuutheikub
laeer	jocnthevartyuttheilub
laefr	jocmthevbrtyustheimub
laegr	joclthevcrtyurtheinub
laehr	jockthevdrtyuqtheioub
laeir	jocjthevertyuptheipub
laejr	jocithevfrtyuotheiqub
laekr	jochthevgrtyuntheirub
laelr	jocgthevhrtyumtheisub
laemr	jocfthevirtyultheitub
laenr	jocethevjrtyuktheiuub
laeor	jocdthevkrtyujtheivub
laepr	joccthevlrtyuitheiwub
laeqr	jocbthevmrtyuhtheixub
laerr	jocathevnrtyugtheiyub
laesr	joczthevortyuftheizub
laetr	jocythevprtyuetheiaub
laeur	jocxthevqrtyudtheibub
laevr	jocwthevrrtyuctheicub
laewr	jocvthevsrtyubtheidub
laexr	jocuthevtrtyuatheieub
laeyr	joctthevurtyuztheifub
laezr	jocsthevvrtyuytheigub
lafar	jobrthewwrtytxthejhub
lafbr	jobqthewxrtytwthejiub
lafcr	jobpthewyrtytvthejjub
lafdr	jobothewzrtytuthejkub
lafer	jobnthewartyttthejlub
laffr	jobmthewbrtytsthejmub
lafgr	joblthewcrtytrthejnub
lafhr	jobkthewdrtytqthejoub
lafir	jobjthewertytpthejpub
lafjr	jobithewfrtytothejqub
lafkr	jobhthewgrtytnthejrub
laflr	jobgthewhrtytmthejsub
lafmr	jobfthewirtytlthejtub
lafnr	jobethewjrtytkthejuub
lafor	jobdthewkrtytjthejvub
lafpr	jobcthewlrtytithejwub
lafqg	jobbehewmgtythehejxjb
lafrr	jobathewnrtytgthejyub
lafsr	jobzthewortytfthejzub
laftr	jobythewprtytethejaub
lafur	jobxthewqrtytdthejbub
lafvr	jobwthewrrtytcthejcub
lafwr	jobvthewsrtytbthejdub
lafxr	jobuthewtrtytathejeub
lafyr	jobtthewurtytzthejfub
lafzr	jobsthewvrtytythejgub
lagar	joarthexwrtysxthekhub
lagbr	joaqthexxrtyswthekiub
lagcr	joapthexyrtysvthekjub
lagdr	joaothexzrtysuthekkub
lager	joanthexartysttheklub
lagfr	joamthexbrtyssthekmub
laggr	joalthexcrtysrtheknub
laghr	joakthexdrtysqthekoub
lagir	joajthexertyspthekpub
lagjr	joaithexfrtysothekqub
lagkr	joahthexgrtysnthekrub
laglr	joagthexhrtysmtheksub
lagmr	joafthexirtyslthektub
lagnr	joaethexjrtyskthekuub
lagor	joadthexkrtysjthekvub
lagpr	joacthexlrtysithekwub
lagqr	joabthexmrtyshthekxub
lagrr	joaathexnrtysgthekyub
lagsr	joazthexortysfthekzub
lagtr	joaythexprtysethekaub
lagur	joaxthexqrtysdthekbub
lagvr	joawthexrrtyscthekcub
lagwr	joavthexsrtysbthekdub
lagxr	joauthextrtysathekeub
lagyr	joatthexurtyszthekfub
lagzr	joasthexvrtysythekgub
lahar	jozrtheywrtyrxthelhub
lahbr	jozqtheyxrtyrwtheliub
lahcr	jozptheyyrtyrvtheljub
lahdr	jozotheyzrtyruthelkub
laher	jozntheyartyrtthellub
lahfr	jozmtheybrtyrsthelmub
lahgr	jozltheycrtyrrthelnub
lahhr	jozktheydrtyrqtheloub
lahir	jozjtheyertyrpthelpub
lahjr	jozitheyfrtyrothelqub
lahkr	jozhtheygrtyrnthelrub
lahlr	jozgtheyhrtyrmthelsub
lahmr	jozftheyirtyrltheltub
lahnr	jozetheyjrtyrktheluub
lahor	jozdtheykrtyrjthelvub
lahpr	jozctheylrtyrithelwub
lahqr	jozbtheymrtyrhthelxub
lahrr	jozatheynrtyrgthelyub
lahsr	jozztheyortyrfthelzub
lahtr	jozytheyprtyrethelaub
lahur	jozxtheyqrtyrdthelbub
lahvr	jozwtheyrrtyrcthelcub
lahwr	jozvtheysrtyrbtheldub
lahxr	jozutheytrtyratheleub
lahyr	jozttheyurtyrzthelfub
lahzr	jozstheyvrtyrythelgub
laiar	joyrthezwrtyqxthemhub
laibr	joyqthezxrtyqwthemiub
laicr	joypthezyrtyqvthemjub
laidr	joyothezzrtyquthemkub
laier	joynthezartyqtthemlub
laifr	joymthezbrtyqsthemmub
laigr	joylthezcrtyqrthemnub
laihr	joykthezdrtyqqthemoub
laiir	joyjthezertyqpthempub
laijr	joyithezfrtyqothemqub
laikr	joyhthezgrtyqnthemrub
lailr	joygthezhrtyqmthemsub
laimr	joyfthezirtyqlthemtub
lainr	joyethezjrtyqkthemuub
laior	joydthezkrtyqjthemvub
laipr	joycthezlrtyqithemwub
laiqr	joybthezmrtyqhthemxub
lairr	joyatheznrtyqgthemyub
laisr	joyzthezortyqfthemzub
laitr	joyythezprtyqethemaub
laiur	joyxthezqrtyqdthembub
laivr	joywthezrrtyqcthemcub
laiwr	joyvthezsrtyqbthemdub
laixr	joyutheztrtyqathemeub
laiyr	joytthezurtyqzthemfub
laizr	joysthezvrtyqythemgub
lajar	joxrtheawrtypxthenhub
lajbr	joxqtheaxrtypwtheniub
lajcr	joxptheayrtypvthenjub
lajdr	joxotheazrtyputhenkub
lajer	joxntheaartyptthenlub
lajfr	joxmtheabrtypsthenmub
lajgr	joxltheacrtyprthennub
lajhr	joxktheadrtypqthenoub
lajir	joxjtheaertyppthenpub
lajjr	joxitheafrtypothenqub
lajkr	joxhtheagrtypnthenrub
lajlr	joxgtheahrtypmthensub
lajmr	joxftheairtyplthentub
lajnr	joxetheajrtypkthenuub
lajor	joxdtheakrtypjthenvub
lajpr	joxcthealrtypithenwub
lajqr	joxbtheamrtyphthenxub
lajrr	joxatheanrtypgthenyub
lajsr	joxztheaortypfthenzub
lajtr	joxytheaprtypethenaub
lajur	joxxtheaqrtypdthenbub
lajvr	joxwthearrtypcthencub
lajwr	joxvtheasrtypbthendub
lajxr	joxutheatrtypatheneub
lajyr	joxttheaurtypzthenfub
lajzr	joxstheavrtypythengub
lakar	jowrthebwrtyoxtheohub
lakbr	jowqthebxrtyowtheoiub
lakcr	jowpthebyrtyovtheojub
lakdr	jowothebzrtyoutheokub
laker	jownthebartyottheolub
lakfr	jowmthebbrtyostheomub
lakgr	jowlthebcrtyortheonub
lakhr	jowkthebdrtyoqtheooub
lakir	jowjthebertyoptheopub
lakjr	jowithebfrtyootheoqub
lakkr	jowhthebgrtyontheorub
laklr	jowgthebhrtyomtheosub
lakmr	jowfthebirtyoltheotub
laknr	jowethebjrtyoktheouub
lakor	jowdthebkrtyojtheovub
lakpr	jowctheblrtyoitheowub
lakqr	jowbthebmrtyohtheoxub
lakrr	jowathebnrtyogtheoyub
laksr	jowzthebortyoftheozub
laktr	jowythebprtyoetheoaub
lakur	jowxthebqrtyodtheobub
lakvr	jowwthebrrtyoctheocub
lakwr	jowvthebsrtyobtheodub
lakxr	jowuthebtrtyoatheoeub
lakyr	jowttheburtyoztheofub
lakzr	jowsthebvrtyoytheogub
lalar	jovrthecwrtynxthephub
lalbr	jovqthecxrtynwthepiub
lalcr	jovpthecyrtynvthepjub
laldr	jovotheczrtynuthepkub
laler	jovnthecartynttheplub
lalfr	jovmthecbrtynsthepmub
lalgr	jovltheccrtynrthepnub
lalhr	jovkthecdrtynqthepoub
lalir	jovjthecertynptheppub
laljr	jovithecfrtynothepqub
lalkr	jovhthecgrtynntheprub
lallr	jovgthechrtynmthepsub
lalmr	jovfthecirtynltheptub
lalnr	jovethecjrtynkthepuub
lalor	jovdtheckrtynjthepvub
lalpr	jovctheclrtynithepwub
lalqr	jovbthecmrtynhthepxub
lalrr	jovathecnrtyngthepyub
lalsr	jovzthecortynfthepzub
laltr	jovythecprtynethepaub
lalur	jovxthecqrtyndthepbub
lalvr	jovwthecrrtyncthepcub
lalwr	jovvthecsrtynbthepdub
lalxr	jovuthectrtynathepeub
lalyr	jovtthecurtynzthepfub
lalzr	jovsthecvrtynythepgub
lamar	jourthedwrtymxtheqhub
lambr	jouqthedxrtymwtheqiub
lamcr	joupthedyrtymvtheqjub
lamdr	jouothedzrtymutheqkub
lamer	jounthedartymttheqlub
lamfr	joumthedbrtymstheqmub
lamgr	joulthedcrtymrtheqnub
lamhr	jouktheddrtymqtheqoub
lamir	joujthedertymptheqpub
lamjr	jouithedfrtymotheqqub
lamkr	jouhthedgrtymntheqrub
lamlr	jougthedhrtymmtheqsub
lammr	joufthedirtymltheqtub
lamnr	jouethedjrtymkthequub
lamor	joudthedkrtymjtheqvub
lampr	joucthedlrtymitheqwub
lamqr	joubthedmrtymhtheqxub
lamrr	jouathednrtymgtheqyub
lamsr	jouzthedortymftheqzub
lamtr	jouythedprtymetheqaub
lamur	jouxthedqrtymdtheqbub
lamvr	jouwthedrrtymctheqcub
lamwr	jouvthedsrtymbtheqdub
lamxr	jouuthedtrtymatheqeub
lamyr	joutthedurtymztheqfub
lamzr	jousthedvrtymytheqgub
lanar	jotrtheewrtylxtherhub
lanbr	jotqtheexrtylwtheriub
lancr	jotptheeyrtylvtherjub
landr	jototheezrtylutherkub
laner	jotntheeartylttherlub
lanfr	jotmtheebrtylsthermub
langr	jotltheecrtylrthernub
lanhr	jotktheedrtylqtheroub
lanir	jotjtheeertylptherpub
lanjr	jotitheefrtylotherqub
lankg	jotheheeggtylneherrjb
lanlr	jotgtheehrtylmthersub
lanmr	jotftheeirtyllthertub
lannr	jotetheejrtylktheruub
lanor	jotdtheekrtyljthervub
lanpr	jotctheelrtylitherwub
lanqr	jotbtheemrtylhtherxub
lanrr	jotatheenrtylgtheryub
lansr	jotztheeortylftherzub
lantr	jotytheeprtyletheraub
lanur	jotxtheeqrtyldtherbub
lanvr	jotwtheerrtylcthercub
lanwr	jotvtheesrtylbtherdub
lanxr	jotutheetrtylathereub
lanyr	jotttheeurtylztherfub
lanzr	jotstheevrtylythergub
laoar	josrthefwrtykxtheshub
laobr	josqthefxrtykwthesiub
laocr	jospthefyrtykvthesjub
laodr	josothefzrtykutheskub
laoer	josnthefartykttheslub
laofr	josmthefbrtyksthesmub
laogr	joslthefcrtykrthesnub
laohr	joskthefdrtykqthesoub
laoir	josjthefertykpthespub
laojr	jositheffrtykothesqub
laokr	joshthefgrtyknthesrub
laolr	josgthefhrtykmthessub
laomr	josfthefirtyklthestub
laonr	josethefjrtykkthesuub
laoor	josdthefkrtykjthesvub
laopr	josctheflrtykitheswub
laoqr	josbthefmrtykhthesxub
laorr	josathefnrtykgthesyub
laosr	joszthefortykftheszub
laotr	josythefprtykethesaub
laour	josxthefqrtykdthesbub
laovr	joswthefrrtykcthescub
laowr	josvthefsrtykbthesdub
laoxr	josutheftrtykatheseub
laoyr	jostthefurtykzthesfub
laozr	jossthefvrtykythesgub
lapab	jorrjhegwbtyjxjhetheb
lapbr	jorqthegxrtyjwthetiub
lapcr	jorpthegyrtyjvthetjub
lapdr	jorothegzrtyjuthetkub
laper	jornthegartyjtthetlub
lapfr	jormthegbrtyjsthetmub
lapgr	jorlthegcrtyjrthetnub
laphr	jorkthegdrtyjqthetoub
lapir	jorjthegertyjpthetpub
lapjr	jorithegfrtyjothetqub
lapkr	jorhtheggrtyjnthetrub
laplr	jorgtheghrtyjmthetsub
lapmr	jorfthegirtyjlthettub
lapnr	jorethegjrtyjkthetuub
lapor	jordthegkrtyjjthetvub
lappr	jorctheglrtyjithetwub
lapqr	jorbthegmrtyjhthetxub
laprr	jorathegnrtyjgthetyub
lapsr	jorzthegortyjfthetzub
laptr	jorythegprtyjethetaub
lapur	jorxthegqrtyjdthetbub
lapvr	jorwthegrrtyjcthetcub
lapwr	jorvthegsrtyjbthetdub
lapxr	joruthegtrtyjatheteub
lapyr	jortthegurtyjzthetfub
lapzr	jorsthegvrtyjythetgub
laqar	joqrthehwrtyixtheuhub
laqbr	joqqthehxrtyiwtheuiub
laqcr	joqpthehyrtyivtheujub
laqdr	joqothehzrtyiutheukub
laqer	joqnthehartyittheulub
laqfr	joqmthehbrtyistheumub
laqgr	joqlthehcrtyirtheunub
laqhr	joqkthehdrtyiqtheuoub
laqir	joqjthehertyiptheupub
laqjr	joqithehfrtyiotheuqub
laqkr	joqhthehgrtyintheurub
laqlr	joqgthehhrtyimtheusub
laqmr	joqfthehirtyiltheutub
laqnr	joqethehjrtyiktheuuub
laqor	joqdthehkrtyijtheuvub
laqpr	joqcthehlrtyiitheuwub
laqqr	joqbthehmrtyihtheuxub
laqrr	joqathehnrtyigtheuyub
laqsr	joqzthehortyiftheuzub
laqtr	joqythehprtyietheuaub
laqur	joqxthehqrtyidtheubub
laqvr	joqwthehrrtyictheucub
laqwr	joqvthehsrtyibtheudub
laqxr	joquthehtrtyiatheueub
laqyr	joqtthehurtyiztheufub
laqzr	joqsthehvrtyiytheugub
larar	joprtheiwrtyhxthevhub
larbr	jopqtheixrtyhwtheviub
larcr	jopptheiyrtyhvthevjub
lardr	jopotheizrtyhuthevkub
larer	jopntheiartyhtthevlub
larfr	jopmtheibrtyhsthevmub
largr	jopltheicrtyhrthevnub
larhr	jopktheidrtyhqthevoub
larir	jopjtheiertyhpthevpub
larjr	jopitheifrtyhothevqub
larkr	jophtheigrtyhnthevrub
larlr	jopgtheihrtyhmthevsub
larmr	jopftheiirtyhlthevtub
larnr	jopetheijrtyhkthevuub
laror	jopdtheikrtyhjthevvub
larpr	jopctheilrtyhithevwub
larqr	jopbtheimrtyhhthevxub
larrr	jopatheinrtyhgthevyub
larsr	jopztheiortyhfthevzub
lartr	jopytheiprtyhethevaub
larur	jopxtheiqrtyhdthevbub
larvr	jopwtheirrtyhcthevcub
larwr	jopvtheisrtyhbthevdub
larxr	joputheitrtyhatheveub
laryr	jopttheiurtyhzthevfub
larzr	jopstheivrtyhythevgub
lasar	joorthejwrtygxthewhub
lasbr	jooqthejxrtygwthewiub
lascr	joopthejyrtygvthewjub
lasdr	jooothejzrtyguthewkub
laser	joonthejartygtthewlub
lasfr	joomthejbrtygsthewmub
lasgr	joolthejcrtygrthewnub
lashr	jookthejdrtygqthewoub
lasir	joojthejertygpthewpub
lasjr	jooithejfrtygothewqub
laskr	joohthejgrtygnthewrub
laslr	joogthejhrtygmthewsub
lasmr	joofthejirtyglthewtub
lasnr	jooethejjrtygkthewuub
lasor	joodthejkrtygjthewvub
laspr	joocthejlrtygithewwub
lasqr	joobthejmrtyghthewxub
lasrr	jooathejnrtyggthewyub
lassr	joozthejortygfthewzub
lastr	jooythejprtygethewaub
lasur	jooxthejqrtygdthewbub
lasvr	joowthejrrtygcthewcub
laswr	joovthejsrtygbthewdub
lasxr	joouthejtrtygatheweub
lasyr	jootthejurtygzthewfub
laszr	joosthejvrtygythewgub
latar	jonrthekwrtyfxthexhub
latbr	jonqthekxrtyfwthexiub
latcr	jonpthekyrtyfvthexjub
latdr	jonothekzrtyfuthexkub
later	jonnthekartyftthexlub
latfr	jonmthekbrtyfsthexmub
latgr	jonlthekcrtyfrthexnub
lathr	jonkthekdrtyfqthexoub
latir	jonjthekertyfpthexpub
latjr	jonithekfrtyfothexqub
latkr	jonhthekgrtyfnthexrub
latlr	jongthekhrtyfmthexsub
latmr	jonfthekirtyflthextub
latnr	jonethekjrtyfkthexuub
lator	jondthekkrtyfjthexvub
latpr	jonctheklrtyfithexwub
latqr	jonbthekmrtyfhthexxub
latrr	jonatheknrtyfgthexyub
latsr	jonzthekortyffthexzub
lattr	jonythekprtyfethexaub
latur	jonxthekqrtyfdthexbub
latvr	jonwthekrrtyfcthexcub
latwr	jonvtheksrtyfbthexdub
latxr	jonuthektrtyfathexeub
latyr	jontthekurtyfzthexfub
latzr	jonsthekvrtyfythexgub
lauar	jomrthelwrtyextheyhub
laubr	jomqthelxrtyewtheyiub
laucr	jompthelyrtyevtheyjub
laudr	jomothelzrtyeutheykub
lauer	jomnthelartyettheylub
laufr	jommthelbrtyestheymub
laugr	jomlthelcrtyertheynub
lauhr	jomktheldrtyeqtheyoub
lauir	jomjthelertyeptheypub
laujr	jomithelfrtyeotheyqub
laukr	jomhthelgrtyentheyrub
laulr	jomgthelhrtyemtheysub
laumr	jomfthelirtyeltheytub
launr	jometheljrtyektheyuub
lauor	jomdthelkrtyejtheyvub
laupr	jomcthellrtyeitheywub
lauqr	jombthelmrtyehtheyxub
laurr	jomathelnrtyegtheyyub
lausr	jomzthelortyeftheyzub
lautr	jomythelprtyeetheyaub
lauur	jomxthelqrtyedtheybub
lauvr	jomwthelrrtyectheycub
lauwr	jomvthelsrtyebtheydub
lauxr	jomutheltrtyeatheyeub
lauyr	jomtthelurtyeztheyfub
lauzr	jomsthelvrtyeytheygub
lavar	jolrthemwrtydxthezhub
lavbr	jolqthemxrtydwtheziub
lavcr	jolpthemyrtydvthezjub
lavdr	jolothemzrtyduthezkub
laver	jolnthemartydtthezlub
lavfr	jolmthembrtydsthezmub
lavgr	jollthemcrtydrtheznub
lavhr	jolkthemdrtydqthezoub
lavir	joljthemertydpthezpub
lavjr	jolithemfrtydothezqub
lavkr	jolhthemgrtydnthezrub
lavlr	jolgthemhrtydmthezsub
lavmr	jolfthemirtydltheztub
lavnr	jolethemjrtydkthezuub
lavor	joldthemkrtydjthezvub
lavpr	jolcthemlrtydithezwub
lavqr	jolbthemmrtydhthezxub
lavrr	jolathemnrtydgthezyub
lavsr	jolzthemortydfthezzub
lavtr	jolythemprtydethezaub
lavur	jolxthemqrtyddthezbub
lavvr	jolwthemrrtydcthezcub
lavwr	jolvthemsrtydbthezdub
lavxr	joluthemtrtydathezeub
lavyr	joltthemurtydzthezfub
lavzr	jolsthemvrtydythezgub
lawar	jokrthenwrtycxtheahub
lawbr	jokqthenxrtycwtheaiub
lawcr	jokpthenyrtycvtheajub
lawdr	jokothenzrtycutheakub
lawer	joknthenartyctthealub
lawfr	jokmthenbrtycstheamub
lawgr	joklthencrtycrtheanub
lawhr	jokkthendrtycqtheaoub
lawir	jokjthenertycptheapub
lawjr	jokithenfrtycotheaqub
lawkr	jokhthengrtycnthearub
lawlr	jokgthenhrtycmtheasub
lawmr	jokfthenirtycltheatub
lawnr	jokethenjrtycktheauub
lawor	jokdthenkrtycjtheavub
lawpr	jokcthenlrtycitheawub
lawqr	jokbthenmrtychtheaxub
lawrr	jokathennrtycgtheayub
lawsr	jokzthenortycftheazub
lawtr	jokythenprtycetheaaub
lawur	jokxthenqrtycdtheabub
lawvr	jokwthenrrtycctheacub
lawwr	jokvthensrtycbtheadub
lawxr	jokuthentrtycatheaeub
lawyr	joktthenurtycztheafub
lawzr	joksthenvrtycytheagub
laxar	jojrtheowrtybxthebhub
laxbr	jojqtheoxrtybwthebiub
laxcr	jojptheoyrtybvthebjub
laxdr	jojotheozrtybuthebkub
laxer	jojntheoartybttheblub
laxfr	jojmtheobrtybsthebmub
laxgr	jojltheocrtybrthebnub
laxhr	jojktheodrtybqtheboub
laxir	jojjtheoertybpthebpub
laxjr	jojitheofrtybothebqub
laxkr	jojhtheogrtybnthebrub
laxlr	jojgtheohrtybmthebsub
laxmr	jojftheoirtyblthebtub
laxnr	jojetheojrtybkthebuub
laxor	jojdtheokrtybjthebvub
laxpr	jojctheolrtybithebwub
laxqr	jojbtheomrtybhthebxub
laxrr	jojatheonrtybgthebyub
laxsr	jojztheoortybfthebzub
laxtr	jojytheoprtybethebaub
laxur	jojxtheoqrtybdthebbub
laxvr	jojwtheorrtybcthebcub
laxwr	jojvtheosrtybbthebdub
laxxr	jojutheotrtybathebeub
laxyr	jojttheourtybzthebfub
laxzr	jojstheovrtybythebgub
layar	joirthepwrtyaxthechub
laybr	joiqthepxrtyawtheciub
laycr	joipthepyrtyavthecjub
laydr	joiothepzrtyautheckub
layer	jointhepartyattheclub
layfr	joimthepbrtyasthecmub
laygr	joilthepcrtyarthecnub
layhr	joikthepdrtyaqthecoub
layir	joijthepertyapthecpub
layjr	joiithepfrtyaothecqub
laykr	joihthepgrtyanthecrub
laylr	joigthephrtyamthecsub
laymr	joifthepirtyalthectub
laynr	joiethepjrtyakthecuub
layor	joidthepkrtyajthecvub
laypr	joictheplrtyaithecwub
layqr	joibthepmrtyahthecxub
layrr	joiathepnrtyagthecyub
laysr	joiztheportyaftheczub
laytr	joiythepprtyaethecaub
layur	joixthepqrtyadthecbub
layvr	joiwtheprrtyactheccub
laywr	joivthepsrtyabthecdub
layxr	joiutheptrtyaatheceub
layyr	joitthepurtyazthecfub
layzr	joisthepvrtyaythecgub
lazar	johrtheqwrtyzxthedhub
lazbr	johqtheqxrtyzwthediub
lazcr	johptheqyrtyzvthedjub
lazdr	johotheqzrtyzuthedkub
lazer	johntheqartyztthedlub
lazfr	johmtheqbrtyzsthedmub
lazgr	johltheqcrtyzrthednub
lazhr	johktheqdrtyzqthedoub
lazir	johjtheqertyzpthedpub
lazjr	johitheqfrtyzothedqub
lazkr	johhtheqgrtyznthedrub
lazlr	johgtheqhrtyzmthedsub
lazmr	johftheqirtyzlthedtub
laznr	johetheqjrtyzktheduub
lazor	johdtheqkrtyzjthedvub
lazpr	johctheqlrtyzithedwub
lazqr	johbtheqmrtyzhthedxub
lazrr	johatheqnrtyzgthedyub
lazsr	johztheqortyzfthedzub
laztr	johytheqprtyzethedaub
lazur	johxtheqqrtyzdthedbub
lazvr	johwtheqrrtyzcthedcub
lazwr	johvtheqsrtyzbtheddub
lazxr	johutheqtrtyzathedeub
lazyr	johtthequrtyzzthedfub
lazzr	johstheqvrtyzythedgub
lbcle	jnegghfthetxwmghfgshb
lbfqg	jnbbehfwmgtxthehfjxjb
lbnkg	jnthehfeggtxlnehfrrjb
lbpab	jnrrjhfgwbtxjxjhftheb
lccle	jmegghgthetwwmghggshb
lcfqg	jmbbehgwmgtwthehgjxjb
lcnkg	jmthehgeggtwlnehgrrjb
lcpab	jmrrjhggwbtwjxjhgtheb
ldcle	jlegghhthetvwmghhgshb
ldfqg	jlbbehhwmgtvthehhjxjb
ldnkg	jlthehheggtvlnehhrrjb
ldpab	jlrrjhhgwbtvjxjhhtheb
lecle	jkegghithetuwmghigshb
lefqg	jkbbehiwmgtuthehijxjb
lenkg	jkthehieggtulnehirrjb
lepab	jkrrjhigwbtujxjhitheb
lfcle	jjegghjthettwmghjgshb
lffqg	jjbbehjwmgttthehjjxjb
lfnkg	jjthehjeggttlnehjrrjb
lfpab	jjrrjhjgwbttjxjhjtheb
lfrta	jjpykhjipatthekhjvadb
lgcle	jiegghkthetswmghkgshb
lgfqg	jibbehkwmgtsthehkjxjb
lgnkg	jithehkeggtslnehkrrjb
lgpab	jirrjhkgwbtsjxjhktheb
lhcle	jhegghlthetrwmghlgshb
lhfqg	jhbbehlwmgtrthehljxjb
lhnkg	jhthehleggtrlnehlrrjb
lhpab	jhrrjhlgwbtrjxjhltheb
licle	jgegghmthetqwmghmgshb
lifqg	jgbbehmwmgtqthehmjxjb
linkg	jgthehmeggtqlnehmrrjb
lipab	jgrrjhmgwbtqjxjhmtheb
ljcle	jfegghnthetpwmghngshb
ljfqg	jfbbehnwmgtpthehnjxjb
ljnkg	jfthehneggtplnehnrrjb
ljpab	jfrrjhngwbtpjxjhntheb
lkcle	jeegghothetowmghogshb
lkfqg	jebbehowmgtothehojxjb
lknkg	jethehoeggtolnehorrjb
lkpab	jerrjhogwbtojxjhotheb
llcle	jdegghpthetnwmghpgshb
llfqg	jdbbehpwmgtnthehpjxjb
llnkg	jdthehpeggtnlnehprrjb
llpab	jdrrjhpgwbtnjxjhptheb
lmcle	jcegghqthetmwmghqgshb
lmfqg	jcbbehqwmgtmthehqjxjb
lmnkg	jcthehqeggtmlnehqrrjb
lmpab	jcrrjhqgwbtmjxjhqtheb
lncle	jbegghrthetlwmghrgshb
lnfqg	jbbbehrwmgtlthehrjxjb
lnnkg	jbthehreggtllnehrrrjb
lnpab	jbrrjhrgwbtljxjhrtheb
locle	jaegghsthetkwmghsgshb
lofqg	jabbehswmgtkthehsjxjb
lonkg	jathehseggtklnehsrrjb
lopab	jarrjhsgwbtkjxjhstheb
lpcle	jzegghtthetjwmghtgshb
lpdxa	jzdukhtutatjvakhthedb
lpfqg	jzbbehtwmgtjthehtjxjb
lpnkg	jzthehteggtjlnehtrrjb
lppab	jzrrjhtgwbtjjxjhttheb
lpqia	jzqjkhtheatjipkhtupdb
lqcle	jyegghuthetiwmghugshb
lqfqg	jybbehuwmgtithehujxjb
lqnkg	jythehueggtilnehurrjb
lqpab	jyrrjhugwbtijxjhutheb
lrcle	jxegghvthethwmghvgshb
lrfqg	jxbbehvwmgththehvjxjb
lrnkg	jxthehveggthlnehvrrjb
lrpab	jxrrjhvgwbthjxjhvtheb
lruaa	jxmrkhvlwathexkhvyhdb
lruba	jxmqkhvlxathewkhvyidb
lruca	jxmpkhvlyathevkhvyjdb
lruda	jxmokhvlzatheukhvykdb
lruea	jxmnkhvlaathetkhvyldb
lrufa	jxmmkhvlbatheskhvymdb
lruga	jxmlkhvlcatherkhvyndb
lruha	jxmkkhvldatheqkhvyodb
lruia	jxmjkhvleathepkhvypdb
lruja	jxmikhvlfatheokhvyqdb
lruka	jxmhkhvlgathenkhvyrdb
lrula	jxmgkhvlhathemkhvysdb
lruma	jxmfkhvliathelkhvytdb
lruna	jxmekhvljathekkhvyudb
lruoa	jxmdkhvlkathejkhvyvdb
lrupa	jxmckhvllatheikhvywdb
lruqa	jxmbkhvlmathehkhvyxdb
lrura	jxmakhvlnathegkhvyydb
lrusa	jxmzkhvloathefkhvyzdb
lruta	jxmykhvlpatheekhvyadb
lruua	jxmxkhvlqathedkhvybdb
lruva	jxmwkhvlratheckhvycdb
lruwa	jxmvkhvlsathebkhvyddb
lruxa	jxmukhvltatheakhvyedb
lruya	jxmtkhvluathezkhvyfdb
lruza	jxmskhvlvatheykhvygdb
lscle	jwegghwthetgwmghwgshb
lsfqg	jwbbehwwmgtgthehwjxjb
lsnkg	jwthehweggtglnehwrrjb
lspab	jwrrjhwgwbtgjxjhwtheb
ltcle	jvegghxthetfwmghxgshb
ltfqg	jvbbehxwmgtfthehxjxjb
ltnkg	jvthehxeggtflnehxrrjb
ltpab	jvrrjhxgwbtfjxjhxtheb
lucle	juegghythetewmghygshb
lufqg	jubbehywmgtethehyjxjb
lunkg	juthehyeggtelnehyrrjb
lupab	jurrjhygwbtejxjhytheb
lvcle	jtegghzthetdwmghzgshb
lvfqg	jtbbehzwmgtdthehzjxjb
lvnkg	jtthehzeggtdlnehzrrjb
lvpab	jtrrjhzgwbtdjxjhztheb
lvzna	jthekhzqjatdzkkhzdudb
lwcle	jsegghathetcwmghagshb
lwfqg	jsbbehawmgtcthehajxjb
lwnkg	jsthehaeggtclneharrjb
lwpab	jsrrjhagwbtcjxjhatheb
lxcle	jregghbthetbwmghbgshb
lxfqg	jrbbehbwmgtbthehbjxjb
lxnkg	jrthehbeggtblnehbrrjb
lxpab	jrrrjhbgwbtbjxjhbtheb
lycle	jqegghcthetawmghcgshb
lyfqg	jqbbehcwmgtathehcjxjb
lynkg	jqthehceggtalnehcrrjb
lypab	jqrrjhcgwbtajxjhctheb
lzcle	jpegghdthetzwmghdgshb
lzfqg	jpbbehdwmgtzthehdjxjb
lznkg	jpthehdeggtzlnehdrrjb
lzpab	jprrjhdgwbtzjxjhdtheb
macle	ioeggiethesywmgiegsha
mafqg	iobbeiewmgsytheiejxja
mankg	iotheieeggsylneierrja
mapab	iorrjiegwbsyjxjiethea
mbcle	ineggifthesxwmgifgsha
mbfqg	inbbeifwmgsxtheifjxja
mbnkg	intheifeggsxlneifrrja
mbpab	inrrjifgwbsxjxjifthea
mccle	imeggigtheswwmgiggsha
mcfqg	imbbeigwmgswtheigjxja
mcnkg	imtheigeggswlneigrrja
mcpab	imrrjiggwbswjxjigthea
mdcle	ileggihthesvwmgihgsha
mdfqg	ilbbeihwmgsvtheihjxja
mdnkg	iltheiheggsvlneihrrja
mdpab	ilrrjihgwbsvjxjihthea
mecle	ikeggiithesuwmgiigsha
mefqg	ikbbeiiwmgsutheiijxja
menkg	iktheiieggsulneiirrja
mepab	ikrrjiigwbsujxjiithea
mfcle	ijeggijthestwmgijgsha
mffqg	ijbbeijwmgsttheijjxja
mfnkg	ijtheijeggstlneijrrja
mfpab	ijrrjijgwbstjxjijthea
mfrta	ijpykijipasthekijvada
mgcle	iieggikthesswmgikgsha
mgfqg	iibbeikwmgsstheikjxja
mgnkg	iitheikeggsslneikrrja
mgpab	iirrjikgwbssjxjikthea
mhcle	iheggilthesrwmgilgsha
mhfqg	ihbbeilwmgsrtheiljxja
mhnkg	ihtheileggsrlneilrrja
mhpab	ihrrjilgwbsrjxjilthea
micle	igeggimthesqwmgimgsha
mifqg	igbbeimwmgsqtheimjxja
minkg	igtheimeggsqlneimrrja
mipab	igrrjimgwbsqjxjimthea
mjcle	ifegginthespwmgingsha
mjfqg	ifbbeinwmgsptheinjxja
mjnkg	iftheineggsplneinrrja
mjpab	ifrrjingwbspjxjinthea
mkcle	ieeggiothesowmgiogsha
mkfqg	iebbeiowmgsotheiojxja
mknkg	ietheioeggsolneiorrja
mkpab	ierrjiogwbsojxjiothea
mlcle	ideggipthesnwmgipgsha
mlfqg	idbbeipwmgsntheipjxja
mlnkg	idtheipeggsnlneiprrja
mlpab	idrrjipgwbsnjxjipthea
mmcle	iceggiqthesmwmgiqgsha
mmfqg	icbbeiqwmgsmtheiqjxja
mmnkg	ictheiqeggsmlneiqrrja
mmpab	icrrjiqgwbsmjxjiqthea
mncle	ibeggirtheslwmgirgsha
mnfqg	ibbbeirwmgsltheirjxja
mnnkg	ibtheireggsllneirrrja
mnpab	ibrrjirgwbsljxjirthea
mocle	iaeggistheskwmgisgsha
mofqg	iabbeiswmgsktheisjxja
monkg	iatheiseggsklneisrrja
mopab	iarrjisgwbskjxjisthea
mpcle	izeggitthesjwmgitgsha
mpdxa	izdukitutasjvakitheda
mpfqg	izbbeitwmgsjtheitjxja
mpnkg	iztheiteggsjlneitrrja
mppab	izrrjitgwbsjjxjitthea
mpqia	izqjkitheasjipkitupda
mqcle	iyeggiuthesiwmgiugsha
mqfqg	iybbeiuwmgsitheiujxja
mqnkg	iytheiueggsilneiurrja
mqpab	iyrrjiugwbsijxjiuthea
mrcle	ixeggivtheshwmgivgsha
mrfqg	ixbbeivwmgshtheivjxja
mrnkg	ixtheiveggshlneivrrja
mrpab	ixrrjivgwbshjxjivthea
mscle	iweggiwthesgwmgiwgsha
msfqg	iwbbeiwwmgsgtheiwjxja
msnkg	iwtheiweggsglneiwrrja
mspab	iwrrjiwgwbsgjxjiwthea
mtcle	iveggixthesfwmgixgsha
mtfqg	ivbbeixwmgsftheixjxja
mtnkg	ivtheixeggsflneixrrja
mtpab	ivrrjixgwbsfjxjixthea
mucle	iueggiythesewmgiygsha
mufqg	iubbeiywmgsetheiyjxja
munkg	iutheiyeggselneiyrrja
mupab	iurrjiygwbsejxjiythea
mvcle	iteggizthesdwmgizgsha
mvfqg	itbbeizwmgsdtheizjxja
mvnkg	ittheizeggsdlneizrrja
mvpab	itrrjizgwbsdjxjizthea
mvzna	ithekizqjasdzkkizduda
mwcle	iseggiathescwmgiagsha
mwfqg	isbbeiawmgsctheiajxja
mwnkg	istheiaeggsclneiarrja
mwpab	isrrjiagwbscjxjiathea
mxcle	ireggibthesbwmgibgsha
mxfqg	irbbeibwmgsbtheibjxja
mxnkg	irtheibeggsblneibrrja
mxpab	irrrjibgwbsbjxjibthea
mycle	iqeggicthesawmgicgsha
myfqg	iqbbeicwmgsatheicjxja
mynkg	iqtheiceggsalneicrrja
mypab	iqrrjicgwbsajxjicthea
mzcle	ipeggidtheszwmgidgsha
mzfqg	ipbbeidwmgsztheidjxja
mznkg	iptheideggszlneidrrja
mzpab	iprrjidgwbszjxjidthea
nacle	hoeggjetherywmgjegshz
nafqg	hobbejewmgrythejejxjz
nankg	hothejeeggrylnejerrjz
napab	horrjjegwbryjxjjethez
nbcle	hneggjftherxwmgjfgshz
nbfqg	hnbbejfwmgrxthejfjxjz
nbnkg	hnthejfeggrxlnejfrrjz
nbpab	hnrrjjfgwbrxjxjjfthez
nccle	hmeggjgtherwwmgjggshz
ncfqg	hmbbejgwmgrwthejgjxjz
ncnkg	hmthejgeggrwlnejgrrjz
ncpab	hmrrjjggwbrwjxjjgthez
ndcle	hleggjhthervwmgjhgshz
ndfqg	hlbbejhwmgrvthejhjxjz
ndnkg	hlthejheggrvlnejhrrjz
ndpab	hlrrjjhgwbrvjxjjhthez
necle	hkeggjitheruwmgjigshz
nefqg	hkbbejiwmgruthejijxjz
nenkg	hkthejieggrulnejirrjz
nepab	hkrrjjigwbrujxjjithez
nfcle	hjeggjjthertwmgjjgshz
nffqg	hjbbejjwmgrtthejjjxjz
nfnkg	hjthejjeggrtlnejjrrjz
nfpab	hjrrjjjgwbrtjxjjjthez
nfrta	hjpykjjiparthekjjvadz
ngcle	hieggjktherswmgjkgshz
ngfqg	hibbejkwmgrsthejkjxjz
ngnkg	hithejkeggrslnejkrrjz
ngpab	hirrjjkgwbrsjxjjkthez
nhcle	hheggjltherrwmgjlgshz
nhfqg	hhbbejlwmgrrthejljxjz
nhnkg	hhthejleggrrlnejlrrjz
nhpab	hhrrjjlgwbrrjxjjlthez
nicle	hgeggjmtherqwmgjmgshz
nifqg	hgbbejmwmgrqthejmjxjz
ninkg	hgthejmeggrqlnejmrrjz
nipab	hgrrjjmgwbrqjxjjmthez
njcle	hfeggjntherpwmgjngshz
njfqg	hfbbejnwmgrpthejnjxjz
njnkg	hfthejneggrplnejnrrjz
njpab	hfrrjjngwbrpjxjjnthez
nkcle	heeggjotherowmgjogshz
nkfqg	hebbejowmgrothejojxjz
nknkg	hethejoeggrolnejorrjz
nkpab	herrjjogwbrojxjjothez
nlcle	hdeggjpthernwmgjpgshz
nlfqg	hdbbejpwmgrnthejpjxjz
nlnkg	hdthejpeggrnlnejprrjz
nlpab	hdrrjjpgwbrnjxjjpthez
nmcle	hceggjqthermwmgjqgshz
nmfqg	hcbbejqwmgrmthejqjxjz
nmnkg	hcthejqeggrmlnejqrrjz
nmpab	hcrrjjqgwbrmjxjjqthez
nncle	hbeggjrtherlwmgjrgshz
nnfqg	hbbbejrwmgrlthejrjxjz
nnnkg	hbthejreggrllnejrrrjz
nnpab	hbrrjjrgwbrljxjjrthez
nocle	haeggjstherkwmgjsgshz
nofqg	habbejswmgrkthejsjxjz
nonkg	hathejseggrklnejsrrjz
nopab	harrjjsgwbrkjxjjsthez
npcle	hzeggjttherjwmgjtgshz
npdxa	hzdukjtutarjvakjthedz
npfqg	hzbbejtwmgrjthejtjxjz
npnkg	hzthejteggrjlnejtrrjz
nppab	hzrrjjtgwbrjjxjjtthez
npqia	hzqjkjthearjipkjtupdz
nqcle	hyeggjutheriwmgjugshz
nqfqg	hybbejuwmgrithejujxjz
nqnkg	hythejueggrilnejurrjz
nqpab	hyrrjjugwbrijxjjuthez
nrcle	hxeggjvtherhwmgjvgshz
nrfqg	hxbbejvwmgrhthejvjxjz
nrnkg	hxthejveggrhlnejvrrjz
nrpab	hxrrjjvgwbrhjxjjvthez
nscle	hweggjwthergwmgjwgshz
nsfqg	hwbbejwwmgrgthejwjxjz
nsnkg	hwthejweggrglnejwrrjz
nspab	hwrrjjwgwbrgjxjjwthez
ntcle	hveggjxtherfwmgjxgshz
ntfqg	hvbbejxwmgrfthejxjxjz
ntnkg	hvthejxeggrflnejxrrjz
ntpab	hvrrjjxgwbrfjxjjxthez
nucle	hueggjytherewmgjygshz
nufqg	hubbejywmgrethejyjxjz
nunkg	huthejyeggrelnejyrrjz
nupab	hurrjjygwbrejxjjythez
nvcle	hteggjztherdwmgjzgshz
nvfqg	htbbejzwmgrdthejzjxjz
nvnkg	htthejzeggrdlnejzrrjz
nvpab	htrrjjzgwbrdjxjjzthez
nvzna	hthekjzqjardzkkjzdudz
nwcle	hseggjathercwmgjagshz
nwfqg	hsbbejawmgrcthejajxjz
nwnkg	hsthejaeggrclnejarrjz
nwpab	hsrrjjagwbrcjxjjathez
nxcle	hreggjbtherbwmgjbgshz
nxfqg	hrbbejbwmgrbthejbjxjz
nxnkg	hrthejbeggrblnejbrrjz
nxpab	hrrrjjbgwbrbjxjjbthez
nycle	hqeggjctherawmgjcgshz
nyfqg	hqbbejcwmgrathejcjxjz
nynkg	hqthejceggralnejcrrjz
nypab	hqrrjjcgwbrajxjjcthez
nzcle	hpeggjdtherzwmgjdgshz
nzfqg	hpbbejdwmgrzthejdjxjz
nznkg	hpthejdeggrzlnejdrrjz
nzpab	hprrjjdgwbrzjxjjdthez
oacle	goeggketheqywmgkegshy
oafqg	gobbekewmgqythekejxjy
oankg	gothekeeggqylnekerrjy
oapab	gorrjkegwbqyjxjkethey
obcle	gneggkftheqxwmgkfgshy
obfqg	gnbbekfwmgqxthekfjxjy
obnkg	gnthekfeggqxlnekfrrjy
obpab	gnrrjkfgwbqxjxjkfthey
occle	gmeggkgtheqwwmgkggshy
ocfqg	gmbbekgwmgqwthekgjxjy
ocnkg	gmthekgeggqwlnekgrrjy
ocpab	gmrrjkggwbqwjxjkgthey
odcle	gleggkhtheqvwmgkhgshy
odfqg	glbbekhwmgqvthekhjxjy
odnkg	glthekheggqvlnekhrrjy
odpab	glrrjkhgwbqvjxjkhthey
oecle	gkeggkithequwmgkigshy
oefqg	gkbbekiwmgquthekijxjy
oenkg	gkthekieggqulnekirrjy
oepab	gkrrjkigwbqujxjkithey
ofcle	gjeggkjtheqtwmgkjgshy
offqg	gjbbekjwmgqtthekjjxjy
ofnkg	gjthekjeggqtlnekjrrjy
ofpab	gjrrjkjgwbqtjxjkjthey
ofrta	gjpykkjipaqthekkjvady
ogcle	gieggkktheqswmgkkgshy
ogfqg	gibbekkwmgqsthekkjxjy
ognkg	githekkeggqslnekkrrjy
ogpab	girrjkkgwbqsjxjkkthey
ohcle	gheggkltheqrwmgklgshy
ohfqg	ghbbeklwmgqrthekljxjy
ohnkg	ghthekleggqrlneklrrjy
ohpab	ghrrjklgwbqrjxjklthey
oicle	ggeggkmtheqqwmgkmgshy
oifqg	ggbbekmwmgqqthekmjxjy
oinkg	ggthekmeggqqlnekmrrjy
oipab	ggrrjkmgwbqqjxjkmthey
ojcle	gfeggkntheqpwmgkngshy
ojfqg	gfbbeknwmgqptheknjxjy
ojnkg	gfthekneggqplneknrrjy
ojpab	gfrrjkngwbqpjxjknthey
okcle	geeggkotheqowmgkogshy
okfqg	gebbekowmgqothekojxjy
oknkg	gethekoeggqolnekorrjy
okpab	gerrjkogwbqojxjkothey
olcle	gdeggkptheqnwmgkpgshy
olfqg	gdbbekpwmgqnthekpjxjy
olnkg	gdthekpeggqnlnekprrjy
olpab	gdrrjkpgwbqnjxjkpthey
omcle	gceggkqtheqmwmgkqgshy
omfqg	gcbbekqwmgqmthekqjxjy
omnkg	gcthekqeggqmlnekqrrjy
ompab	gcrrjkqgwbqmjxjkqthey
oncle	gbeggkrtheqlwmgkrgshy
onfqg	gbbbekrwmgqlthekrjxjy
onnkg	gbthekreggqllnekrrrjy
onpab	gbrrjkrgwbqljxjkrthey
oocle	gaeggkstheqkwmgksgshy
oofqg	gabbekswmgqktheksjxjy
oonkg	gathekseggqklneksrrjy
oopab	garrjksgwbqkjxjksthey
opcle	gzeggkttheqjwmgktgshy
opdxa	gzdukktutaqjvakkthedy
opfqg	gzbbektwmgqjthektjxjy
opnkg	gzthekteggqjlnektrrjy
oppab	gzrrjktgwbqjjxjktthey
opqia	gzqjkktheaqjipkktupdy
oqcle	gyeggkutheqiwmgkugshy
oqfqg	gybbekuwmgqithekujxjy
oqnkg	gythekueggqilnekurrjy
oqpab	gyrrjkugwbqijxjkuthey
orcle	gxeggkvtheqhwmgkvgshy
orfqg	gxbbekvwmgqhthekvjxjy
ornkg	gxthekveggqhlnekvrrjy
orpab	gxrrjkvgwbqhjxjkvthey
oscle	gweggkwtheqgwmgkwgshy
osfqg	gwbbekwwmgqgthekwjxjy
osnkg	gwthekweggqglnekwrrjy
ospab	gwrrjkwgwbqgjxjkwthey
otcle	gveggkxtheqfwmgkxgshy
otfqg	gvbbekxwmgqfthekxjxjy
otnkg	gvthekxeggqflnekxrrjy
otpab	gvrrjkxgwbqfjxjkxthey
oucle	gueggkytheqewmgkygshy
oufqg	gubbekywmgqethekyjxjy
ounkg	guthekyeggqelnekyrrjy
oupab	gurrjkygwbqejxjkythey
ovcle	gteggkztheqdwmgkzgshy
ovfqg	gtbbekzwmgqdthekzjxjy
ovnkg	gtthekzeggqdlnekzrrjy
ovpab	gtrrjkzgwbqdjxjkzthey
ovzna	gthekkzqjaqdzkkkzdudy
owcle	gseggkatheqcwmgkagshy
owfqg	gsbbekawmgqcthekajxjy
ownkg	gsthekaeggqclnekarrjy
owpab	gsrrjkagwbqcjxjkathey
oxcle	greggkbtheqbwmgkbgshy
oxfqg	grbbekbwmgqbthekbjxjy
oxnkg	grthekbeggqblnekbrrjy
oxpab	grrrjkbgwbqbjxjkbthey
oycle	gqeggkctheqawmgkcgshy
oyfqg	gqbbekcwmgqathekcjxjy
oynkg	gqthekceggqalnekcrrjy
oypab	gqrrjkcgwbqajxjkcthey
ozcle	gpeggkdtheqzwmgkdgshy
ozfqg	gpbbekdwmgqzthekdjxjy
oznkg	gpthekdeggqzlnekdrrjy
ozpab	gprrjkdgwbqzjxjkdthey
pacle	foegglethepywmglegshx
pafqg	fobbelewmgpythelejxjx
pankg	fotheleeggpylnelerrjx
papab	forrjlegwbpyjxjlethex
pbcle	fnegglfthepxwmglfgshx
pbfqg	fnbbelfwmgpxthelfjxjx
pbnkg	fnthelfeggpxlnelfrrjx
pbpab	fnrrjlfgwbpxjxjlfthex
pccle	fmegglgthepwwmglggshx
pcfqg	fmbbelgwmgpwthelgjxjx
pcnkg	fmthelgeggpwlnelgrrjx
pcpab	fmrrjlggwbpwjxjlgthex
pdcle	flegglhthepvwmglhgshx
pdfqg	flbbelhwmgpvthelhjxjx
pdnkg	flthelheggpvlnelhrrjx
pdpab	flrrjlhgwbpvjxjlhthex
pecle	fkegglithepuwmgligshx
pefqg	fkbbeliwmgputhelijxjx
penkg	fkthelieggpulnelirrjx
pepab	fkrrjligwbpujxjlithex
pfcle	fjeggljtheptwmgljgshx
pffqg	fjbbeljwmgpttheljjxjx
pfnkg	fjtheljeggptlneljrrjx
pfpab	fjrrjljgwbptjxjljthex
pfrta	fjpykljipapthekljvadx
pgcle	fiegglkthepswmglkgshx
pgfqg	fibbelkwmgpsthelkjxjx
pgnkg	fithelkeggpslnelkrrjx
pgpab	firrjlkgwbpsjxjlkthex
phcle	fhegglltheprwmgllgshx
phfqg	fhbbellwmgprthelljxjx
phnkg	fhthelleggprlnellrrjx
phpab	fhrrjllgwbprjxjllthex
picle	fgegglmthepqwmglmgshx
pifqg	fgbbelmwmgpqthelmjxjx
pinkg	fgthelmeggpqlnelmrrjx
pipab	fgrrjlmgwbpqjxjlmthex
pjcle	ffegglntheppwmglngshx
pjfqg	ffbbelnwmgppthelnjxjx
pjnkg	ffthelneggpplnelnrrjx
pjpab	ffrrjlngwbppjxjlnthex
pkcle	feegglothepowmglogshx
pkfqg	febbelowmgpothelojxjx
pknkg	fetheloeggpolnelorrjx
pkpab	ferrjlogwbpojxjlothex
plcle	fdegglpthepnwmglpgshx
plfqg	fdbbelpwmgpnthelpjxjx
plnkg	fdthelpeggpnlnelprrjx
plpab	fdrrjlpgwbpnjxjlpthex
pmcle	fcegglqthepmwmglqgshx
pmfqg	fcbbelqwmgpmthelqjxjx
pmnkg	fcthelqeggpmlnelqrrjx
pmpab	fcrrjlqgwbpmjxjlqthex
pncle	fbegglrtheplwmglrgshx
pnfqg	fbbbelrwmgplthelrjxjx
pnnkg	fbthelreggpllnelrrrjx
pnpab	fbrrjlrgwbpljxjlrthex
pocle	faegglsthepkwmglsgshx
pofqg	fabbelswmgpkthelsjxjx
ponkg	fathelseggpklnelsrrjx
popab	farrjlsgwbpkjxjlsthex
ppcle	fzeggltthepjwmgltgshx
ppdxa	fzdukltutapjvaklthedx
ppfqg	fzbbeltwmgpjtheltjxjx
ppnkg	fzthelteggpjlneltrrjx
pppab	fzrrjltgwbpjjxjltthex
ppqia	fzqjkltheapjipkltupdx
pqcle	fyeggluthepiwmglugshx
pqfqg	fybbeluwmgpithelujxjx
pqnkg	fythelueggpilnelurrjx
pqpab	fyrrjlugwbpijxjluthex
prcle	fxegglvthephwmglvgshx
prfqg	fxbbelvwmgphthelvjxjx
prnkg	fxthelveggphlnelvrrjx
prpab	fxrrjlvgwbphjxjlvthex
pscle	fwegglwthepgwmglwgshx
psfqg	fwbbelwwmgpgthelwjxjx
psnkg	fwthelweggpglnelwrrjx
pspab	fwrrjlwgwbpgjxjlwthex
ptcle	fvegglxthepfwmglxgshx
ptfqg	fvbbelxwmgpfthelxjxjx
ptnkg	fvthelxeggpflnelxrrjx
ptpab	fvrrjlxgwbpfjxjlxthex
pucle	fuegglythepewmglygshx
pufqg	fubbelywmgpethelyjxjx
punkg	futhelyeggpelnelyrrjx
pupab	furrjlygwbpejxjlythex
pvcle	ftegglzthepdwmglzgshx
pvfqg	ftbbelzwmgpdthelzjxjx
pvnkg	ftthelzeggpdlnelzrrjx
pvpab	ftrrjlzgwbpdjxjlzthex
pvzna	ftheklzqjapdzkklzdudx
pwcle	fsegglathepcwmglagshx
pwfqg	fsbbelawmgpcthelajxjx
pwnkg	fsthelaeggpclnelarrjx
pwpab	fsrrjlagwbpcjxjlathex
pxcle	fregglbthepbwmglbgshx
pxfqg	frbbelbwmgpbthelbjxjx
pxnkg	frthelbeggpblnelbrrjx
pxpab	frrrjlbgwbpbjxjlbthex
pycle	fqegglcthepawmglcgshx
pyfqg	fqbbelcwmgpathelcjxjx
pynkg	fqthelceggpalnelcrrjx
pypab	fqrrjlcgwbpajxjlcthex
pzcle	fpeggldthepzwmgldgshx
pzfqg	fpbbeldwmgpztheldjxjx
pznkg	fptheldeggpzlneldrrjx
pzpab	fprrjldgwbpzjxjldthex
qacle	eoeggmetheoywmgmegshw
qafqg	eobbemewmgoythemejxjw
qankg	eothemeeggoylnemerrjw
qapab	eorrjmegwboyjxjmethew
qbcle	eneggmftheoxwmgmfgshw
qbfqg	enbbemfwmgoxthemfjxjw
qbnkg	enthemfeggoxlnemfrrjw
qbpab	enrrjmfgwboxjxjmfthew
qccle	emeggmgtheowwmgmggshw
qcfqg	embbemgwmgowthemgjxjw
qcnkg	emthemgeggowlnemgrrjw
qcpab	emrrjmggwbowjxjmgthew
qdcle	eleggmhtheovwmgmhgshw
qdfqg	elbbemhwmgovthemhjxjw
qdnkg	elthemheggovlnemhrrjw
qdpab	elrrjmhgwbovjxjmhthew
qecle	ekeggmitheouwmgmigshw
qefqg	ekbbemiwmgouthemijxjw
qenkg	ekthemieggoulnemirrjw
qepab	ekrrjmigwboujxjmithew
qfcle	ejeggmjtheotwmgmjgshw
qffqg	ejbbemjwmgotthemjjxjw
qfnkg	ejthemjeggotlnemjrrjw
qfpab	ejrrjmjgwbotjxjmjthew
qfrta	ejpykmjipaothekmjvadw
qgcle	eieggmktheoswmgmkgshw
qgfqg	eibbemkwmgosthemkjxjw
qgnkg	eithemkeggoslnemkrrjw
qgpab	eirrjmkgwbosjxjmkthew
qhcle	eheggmltheorwmgmlgshw
qhfqg	ehbbemlwmgorthemljxjw
qhnkg	ehthemleggorlnemlrrjw
qhpab	ehrrjmlgwborjxjmlthew
qicle	egeggmmtheoqwmgmmgshw
qifqg	egbbemmwmgoqthemmjxjw
qinkg	egthemmeggoqlnemmrrjw
qipab	egrrjmmgwboqjxjmmthew
qjcle	efeggmntheopwmgmngshw
qjfqg	efbbemnwmgopthemnjxjw
qjnkg	efthemneggoplnemnrrjw
qjpab	efrrjmngwbopjxjmnthew
qkcle	eeeggmotheoowmgmogshw
qkfqg	eebbemowmgoothemojxjw
qknkg	eethemoeggoolnemorrjw
qkpab	eerrjmogwboojxjmothew
qlcle	edeggmptheonwmgmpgshw
qlfqg	edbbempwmgonthempjxjw
qlnkg	edthempeggonlnemprrjw
qlpab	edrrjmpgwbonjxjmpthew
qmcle	eceggmqtheomwmgmqgshw
qmfqg	ecbbemqwmgomthemqjxjw
qmnkg	ecthemqeggomlnemqrrjw
qmpab	ecrrjmqgwbomjxjmqthew
qncle	ebeggmrtheolwmgmrgshw
qnfqg	ebbbemrwmgolthemrjxjw
qnnkg	ebthemreggollnemrrrjw
qnpab	ebrrjmrgwboljxjmrthew
qocle	eaeggmstheokwmgmsgshw
qofqg	eabbemswmgokthemsjxjw
qonkg	eathemseggoklnemsrrjw
qopab	earrjmsgwbokjxjmsthew
qpcle	ezeggmttheojwmgmtgshw
qpdxa	ezdukmtutaojvakmthedw
qpfqg	ezbbemtwmgojthemtjxjw
qpnkg	ezthemteggojlnemtrrjw
qppab	ezrrjmtgwbojjxjmtthew
qpqia	ezqjkmtheaojipkmtupdw
qqcle	eyeggmutheoiwmgmugshw
qqfqg	eybbemuwmgoithemujxjw
qqnkg	eythemueggoilnemurrjw
qqpab	eyrrjmugwboijxjmuthew
qrcle	exeggmvtheohwmgmvgshw
qrfqg	exbbemvwmgohthemvjxjw
qrnkg	exthemveggohlnemvrrjw
qrpab	exrrjmvgwbohjxjmvthew
qscle	eweggmwtheogwmgmwgshw
qsfqg	ewbbemwwmgogthemwjxjw
qsnkg	ewthemweggoglnemwrrjw
qspab	ewrrjmwgwbogjxjmwthew
qtcle	eveggmxtheofwmgmxgshw
qtfqg	evbbemxwmgofthemxjxjw
qtnkg	evthemxeggoflnemxrrjw
qtpab	evrrjmxgwbofjxjmxthew
qucle	eueggmytheoewmgmygshw
qufqg	eubbemywmgoethemyjxjw
qunkg	euthemyeggoelnemyrrjw
qupab	eurrjmygwboejxjmythew
qvcle	eteggmztheodwmgmzgshw
qvfqg	etbbemzwmgodthemzjxjw
qvnkg	etthemzeggodlnemzrrjw
qvpab	etrrjmzgwbodjxjmzthew
qvzna	ethekmzqjaodzkkmzdudw
qwcle	eseggmatheocwmgmagshw
qwfqg	esbbemawmgocthemajxjw
qwnkg	esthemaeggoclnemarrjw
qwpab	esrrjmagwbocjxjmathew
qxcle	ereggmbtheobwmgmbgshw
qxfqg	erbbembwmgobthembjxjw
qxnkg	erthembeggoblnembrrjw
qxpab	errrjmbgwbobjxjmbthew
qycle	eqeggmctheoawmgmcgshw
qyfqg	eqbbemcwmgoathemcjxjw
qynkg	eqthemceggoalnemcrrjw
qypab	eqrrjmcgwboajxjmcthew
qzcle	epeggmdtheozwmgmdgshw
qzfqg	epbbemdwmgozthemdjxjw
qznkg	epthemdeggozlnemdrrjw
qzpab	eprrjmdgwbozjxjmdthew
racle	doeggnethenywmgnegshv
rafqg	dobbenewmgnythenejxjv
rankg	dotheneeggnylnenerrjv
rapab	dorrjnegwbnyjxjnethev
rbcle	dneggnfthenxwmgnfgshv
rbfqg	dnbbenfwmgnxthenfjxjv
rbnkg	dnthenfeggnxlnenfrrjv
rbpab	dnrrjnfgwbnxjxjnfthev
rccle	dmeggngthenwwmgnggshv
rcfqg	dmbbengwmgnwthengjxjv
rcnkg	dmthengeggnwlnengrrjv
rcpab	dmrrjnggwbnwjxjngthev
rdcle	dleggnhthenvwmgnhgshv
rdfqg	dlbbenhwmgnvthenhjxjv
rdnkg	dlthenheggnvlnenhrrjv
rdpab	dlrrjnhgwbnvjxjnhthev
recle	dkeggnithenuwmgnigshv
refqg	dkbbeniwmgnuthenijxjv
renkg	dkthenieggnulnenirrjv
repab	dkrrjnigwbnujxjnithev
rfcle	djeggnjthentwmgnjgshv
rffqg	djbbenjwmgntthenjjxjv
rfnkg	djthenjeggntlnenjrrjv
rfpab	djrrjnjgwbntjxjnjthev
rfrta	djpyknjipantheknjvadv
rgcle	dieggnkthenswmgnkgshv
rgfqg	dibbenkwmgnsthenkjxjv
rgnkg	dithenkeggnslnenkrrjv
rgpab	dirrjnkgwbnsjxjnkthev
rhcle	dheggnlthenrwmgnlgshv
rhfqg	dhbbenlwmgnrthenljxjv
rhnkg	dhthenleggnrlnenlrrjv
rhpab	dhrrjnlgwbnrjxjnlthev
ricle	dgeggnmthenqwmgnmgshv
rifqg	dgbbenmwmgnqthenmjxjv
rinkg	dgthenmeggnqlnenmrrjv
ripab	dgrrjnmgwbnqjxjnmthev
rjcle	dfeggnnthenpwmgnngshv
rjfqg	dfbbennwmgnpthennjxjv
rjnkg	dfthenneggnplnennrrjv
rjpab	dfrrjnngwbnpjxjnnthev
rkcle	deeggnothenowmgnogshv
rkfqg	debbenowmgnothenojxjv
rknkg	dethenoeggnolnenorrjv
rkpab	derrjnogwbnojxjnothev
rlcle	ddeggnpthennwmgnpgshv
rlfqg	ddbbenpwmgnnthenpjxjv
rlnkg	ddthenpeggnnlnenprrjv
rlpab	ddrrjnpgwbnnjxjnpthev
rmcle	dceggnqthenmwmgnqgshv
rmfqg	dcbbenqwmgnmthenqjxjv
rmnkg	dcthenqeggnmlnenqrrjv
rmpab	dcrrjnqgwbnmjxjnqthev
rncle	dbeggnrthenlwmgnrgshv
rnfqg	dbbbenrwmgnlthenrjxjv
rnnkg	dbthenreggnllnenrrrjv
rnpab	dbrrjnrgwbnljxjnrthev
rocle	daeggnsthenkwmgnsgshv
rofqg	dabbenswmgnkthensjxjv
ronkg	dathenseggnklnensrrjv
ropab	darrjnsgwbnkjxjnsthev
rpcle	dzeggntthenjwmgntgshv
rpdxa	dzdukntutanjvaknthedv
rpfqg	dzbbentwmgnjthentjxjv
rpnkg	dzthenteggnjlnentrrjv
rppab	dzrrjntgwbnjjxjntthev
rpqia	dzqjkntheanjipkntupdv
rqcle	dyeggnutheniwmgnugshv
rqfqg	dybbenuwmgnithenujxjv
rqnkg	dythenueggnilnenurrjv
rqpab	dyrrjnugwbnijxjnuthev
rrcle	dxeggnvthenhwmgnvgshv
rrfqg	dxbbenvwmgnhthenvjxjv
rrnkg	dxthenveggnhlnenvrrjv
rrpab	dxrrjnvgwbnhjxjnvthev
rscle	dweggnwthengwmgnwgshv
rsfqg	dwbbenwwmgngthenwjxjv
rsnkg	dwthenweggnglnenwrrjv
rspab	dwrrjnwgwbngjxjnwthev
rtcle	dveggnxthenfwmgnxgshv
rtfqg	dvbbenxwmgnfthenxjxjv
rtnkg	dvthenxeggnflnenxrrjv
rtpab	dvrrjnxgwbnfjxjnxthev
rucle	dueggnythenewmgnygshv
rufqg	dubbenywmgnethenyjxjv
runkg	duthenyeggnelnenyrrjv
rupab	durrjnygwbnejxjnythev
rvcle	dteggnzthendwmgnzgshv
rvfqg	dtbbenzwmgndthenzjxjv
rvnkg	dtthenzeggndlnenzrrjv
rvpab	dtrrjnzgwbndjxjnzthev
rvzna	dtheknzqjandzkknzdudv
rwcle	dseggnathencwmgnagshv
rwfqg	dsbbenawmgncthenajxjv
rwnkg	dsthenaeggnclnenarrjv
rwpab	dsrrjnagwbncjxjnathev
rxcle	dreggnbthenbwmgnbgshv
rxfqg	drbbenbwmgnbthenbjxjv
rxnkg	drthenbeggnblnenbrrjv
rxpab	drrrjnbgwbnbjxjnbthev
rycle	dqeggncthenawmgncgshv
ryfqg	dqbbencwmgnathencjxjv
rynkg	dqthenceggnalnencrrjv
rypab	dqrrjncgwbnajxjncthev
rzcle	dpeggndthenzwmgndgshv
rzfqg	dpbbendwmgnzthendjxjv
rznkg	dpthendeggnzlnendrrjv
rzpab	dprrjndgwbnzjxjndthev
sacle	coeggoethemywmgoegshu
safqg	cobbeoewmgmytheoejxju
sankg	cotheoeeggmylneoerrju
sapab	corrjoegwbmyjxjoetheu
sbcle	cneggofthemxwmgofgshu
sbfqg	cnbbeofwmgmxtheofjxju
sbnkg	cntheofeggmxlneofrrju
sbpab	cnrrjofgwbmxjxjoftheu
sccle	cmeggogthemwwmgoggshu
scfqg	cmbbeogwmgmwtheogjxju
scnkg	cmtheogeggmwlneogrrju
scpab	cmrrjoggwbmwjxjogtheu
sdcle	cleggohthemvwmgohgshu
sdfqg	clbbeohwmgmvtheohjxju
sdnkg	cltheoheggmvlneohrrju
sdpab	clrrjohgwbmvjxjohtheu
secle	ckeggoithemuwmgoigshu
sefqg	ckbbeoiwmgmutheoijxju
senkg	cktheoieggmulneoirrju
sepab	ckrrjoigwbmujxjoitheu
sfcle	cjeggojthemtwmgojgshu
sffqg	cjbbeojwmgmttheojjxju
sfnkg	cjtheojeggmtlneojrrju
sfpab	cjrrjojgwbmtjxjojtheu
sfrta	cjpykojipamthekojvadu
sgcle	cieggokthemswmgokgshu
sgfqg	cibbeokwmgmstheokjxju
sgnkg	citheokeggmslneokrrju
sgpab	cirrjokgwbmsjxjoktheu
shcle	cheggolthemrwmgolgshu
shfqg	chbbeolwmgmrtheoljxju
shnkg	chtheoleggmrlneolrrju
shpab	chrrjolgwbmrjxjoltheu
sicle	cgeggomthemqwmgomgshu
sifqg	cgbbeomwmgmqtheomjxju
sinkg	cgtheomeggmqlneomrrju
sipab	cgrrjomgwbmqjxjomtheu
sjcle	cfeggonthempwmgongshu
sjfqg	cfbbeonwmgmptheonjxju
sjnkg	cftheoneggmplneonrrju
sjpab	cfrrjongwbmpjxjontheu
skcle	ceeggoothemowmgoogshu
skfqg	cebbeoowmgmotheoojxju
sknkg	cetheooeggmolneoorrju
skpab	cerrjoogwbmojxjootheu
slcle	cdeggopthemnwmgopgshu
slfqg	cdbbeopwmgmntheopjxju
slnkg	cdtheopeggmnlneoprrju
slpab	cdrrjopgwbmnjxjoptheu
smcle	cceggoqthemmwmgoqgshu
smfqg	ccbbeoqwmgmmtheoqjxju
smnkg	cctheoqeggmmlneoqrrju
smpab	ccrrjoqgwbmmjxjoqtheu
sncle	cbeggorthemlwmgorgshu
snfqg	cbbbeorwmgmltheorjxju
snnkg	cbtheoreggmllneorrrju
snpab	cbrrjorgwbmljxjortheu
socle	caeggosthemkwmgosgshu
sofqg	cabbeoswmgmktheosjxju
sonkg	catheoseggmklneosrrju
sopab	carrjosgwbmkjxjostheu
spcle	czeggotthemjwmgotgshu
spdxa	czdukotutamjvakothedu
spfqg	czbbeotwmgmjtheotjxju
spnkg	cztheoteggmjlneotrrju
sppab	czrrjotgwbmjjxjottheu
spqia	czqjkotheamjipkotupdu
sqcle	cyeggouthemiwmgougshu
sqfqg	cybbeouwmgmitheoujxju
sqnkg	cytheoueggmilneourrju
sqpab	cyrrjougwbmijxjoutheu
srcle	cxeggovthemhwmgovgshu
srfqg	cxbbeovwmgmhtheovjxju
srnkg	cxtheoveggmhlneovrrju
srpab	cxrrjovgwbmhjxjovtheu
sscle	cweggowthemgwmgowgshu
ssfqg	cwbbeowwmgmgtheowjxju
ssnkg	cwtheoweggmglneowrrju
sspab	cwrrjowgwbmgjxjowtheu
stcle	cveggoxthemfwmgoxgshu
stfqg	cvbbeoxwmgmftheoxjxju
stnkg	cvtheoxeggmflneoxrrju
stpab	cvrrjoxgwbmfjxjoxtheu
sucle	cueggoythemewmgoygshu
sufqg	cubbeoywmgmetheoyjxju
sunkg	cutheoyeggmelneoyrrju
supab	currjoygwbmejxjoytheu
svcle	cteggozthemdwmgozgshu
svfqg	ctbbeozwmgmdtheozjxju
svnkg	cttheozeggmdlneozrrju
svpab	ctrrjozgwbmdjxjoztheu
svzna	cthekozqjamdzkkozdudu
swcle	cseggoathemcwmgoagshu
swfqg	csbbeoawmgmctheoajxju
swnkg	cstheoaeggmclneoarrju
swpab	csrrjoagwbmcjxjoatheu
sxcle	creggobthembwmgobgshu
sxfqg	crbbeobwmgmbtheobjxju
sxnkg	crtheobeggmblneobrrju
sxpab	crrrjobgwbmbjxjobtheu
sycle	cqeggocthemawmgocgshu
syfqg	cqbbeocwmgmatheocjxju
synkg	cqtheoceggmalneocrrju
sypab	cqrrjocgwbmajxjoctheu
szcle	cpeggodthemzwmgodgshu
szfqg	cpbbeodwmgmztheodjxju
sznkg	cptheodeggmzlneodrrju
szpab	cprrjodgwbmzjxjodtheu
tacle	boeggpethelywmgpegsht
tafqg	bobbepewmglythepejxjt
tankg	bothepeegglylneperrjt
tapab	borrjpegwblyjxjpethet
tbcle	bneggpfthelxwmgpfgsht
tbfqg	bnbbepfwmglxthepfjxjt
tbnkg	bnthepfegglxlnepfrrjt
tbpab	bnrrjpfgwblxjxjpfthet
tccle	bmeggpgthelwwmgpggsht
tcfqg	bmbbepgwmglwthepgjxjt
tcnkg	bmthepgegglwlnepgrrjt
tcpab	bmrrjpggwblwjxjpgthet
tdcle	bleggphthelvwmgphgsht
tdfqg	blbbephwmglvthephjxjt
tdnkg	blthephegglvlnephrrjt
tdpab	blrrjphgwblvjxjphthet
tecle	bkeggpitheluwmgpigsht
tefqg	bkbbepiwmgluthepijxjt
tenkg	bkthepiegglulnepirrjt
tepab	bkrrjpigwblujxjpithet
tfcle	bjeggpjtheltwmgpjgsht
tffqg	bjbbepjwmgltthepjjxjt
tfnkg	bjthepjeggltlnepjrrjt
tfpab	bjrrjpjgwbltjxjpjthet
tfrta	bjpykpjipalthekpjvadt
tgcle	bieggpkthelswmgpkgsht
tgfqg	bibbepkwmglsthepkjxjt
tgnkg	bithepkegglslnepkrrjt
tgpab	birrjpkgwblsjxjpkthet
thcle	bheggplthelrwmgplgsht
thfqg	bhbbeplwmglrthepljxjt
thnkg	bhtheplegglrlneplrrjt
thpab	bhrrjplgwblrjxjplthet
ticle	bgeggpmthelqwmgpmgsht
tifqg	bgbbepmwmglqthepmjxjt
tinkg	bgthepmegglqlnepmrrjt
tipab	bgrrjpmgwblqjxjpmthet
tjcle	bfeggpnthelpwmgpngsht
tjfqg	bfbbepnwmglpthepnjxjt
tjnkg	bfthepnegglplnepnrrjt
tjpab	bfrrjpngwblpjxjpnthet
tkcle	beeggpothelowmgpogsht
tkfqg	bebbepowmglothepojxjt
tknkg	bethepoegglolneporrjt
tkpab	berrjpogwblojxjpothet
tlcle	bdeggppthelnwmgppgsht
tlfqg	bdbbeppwmglntheppjxjt
tlnkg	bdtheppegglnlnepprrjt
tlpab	bdrrjppgwblnjxjppthet
tmcle	bceggpqthelmwmgpqgsht
tmfqg	bcbbepqwmglmthepqjxjt
tmnkg	bcthepqegglmlnepqrrjt
tmpab	bcrrjpqgwblmjxjpqthet
tncle	bbeggprthellwmgprgsht
tnfqg	bbbbeprwmglltheprjxjt
tnnkg	bbthepregglllneprrrjt
tnpab	bbrrjprgwblljxjprthet
tocle	baeggpsthelkwmgpsgsht
tofqg	babbepswmglkthepsjxjt
tonkg	bathepsegglklnepsrrjt
topab	barrjpsgwblkjxjpsthet
tpcle	bzeggpttheljwmgptgsht
tpdxa	bzdukptutaljvakpthedt
tpfqg	bzbbeptwmgljtheptjxjt
tpnkg	bzthepteggljlneptrrjt
tppab	bzrrjptgwbljjxjptthet
tpqia	bzqjkpthealjipkptupdt
tqcle	byeggputheliwmgpugsht
tqfqg	bybbepuwmglithepujxjt
tqnkg	bythepuegglilnepurrjt
tqpab	byrrjpugwblijxjputhet
trcle	bxeggpvthelhwmgpvgsht
trfqg	bxbbepvwmglhthepvjxjt
trnkg	bxthepvegglhlnepvrrjt
trpab	bxrrjpvgwblhjxjpvthet
tscle	bweggpwthelgwmgpwgsht
tsfqg	bwbbepwwmglgthepwjxjt
tsnkg	bwthepwegglglnepwrrjt
tspab	bwrrjpwgwblgjxjpwthet
ttcle	bveggpxthelfwmgpxgsht
ttfqg	bvbbepxwmglfthepxjxjt
ttnkg	bvthepxegglflnepxrrjt
ttpab	bvrrjpxgwblfjxjpxthet
tucle	bueggpythelewmgpygsht
tufqg	bubbepywmglethepyjxjt
tunkg	buthepyegglelnepyrrjt
tupab	burrjpygwblejxjpythet
tvcle	bteggpztheldwmgpzgsht
tvfqg	btbbepzwmgldthepzjxjt
tvnkg	btthepzeggldlnepzrrjt
tvpab	btrrjpzgwbldjxjpzthet
tvzna	bthekpzqjaldzkkpzdudt
twcle	bseggpathelcwmgpagsht
twfqg	bsbbepawmglcthepajxjt
twnkg	bsthepaegglclneparrjt
twpab	bsrrjpagwblcjxjpathet
txcle	breggpbthelbwmgpbgsht
txfqg	brbbepbwmglbthepbjxjt
txnkg	brthepbegglblnepbrrjt
txpab	brrrjpbgwblbjxjpbthet
tycle	bqeggpcthelawmgpcgsht
tyfqg	bqbbepcwmglathepcjxjt
tynkg	bqthepcegglalnepcrrjt
typab	bqrrjpcgwblajxjpcthet
tzcle	bpeggpdthelzwmgpdgsht
tzfqg	bpbbepdwmglzthepdjxjt
tznkg	bpthepdegglzlnepdrrjt
tzpab	bprrjpdgwblzjxjpdthet
uacle	aoeggqethekywmgqegshs
uafqg	aobbeqewmgkytheqejxjs
uankg	aotheqeeggkylneqerrjs
uapab	aorrjqegwbkyjxjqethes
ubcle	aneggqfthekxwmgqfgshs
ubfqg	anbbeqfwmgkxtheqfjxjs
ubnkg	antheqfeggkxlneqfrrjs
ubpab	anrrjqfgwbkxjxjqfthes
uccle	ameggqgthekwwmgqggshs
ucfqg	ambbeqgwmgkwtheqgjxjs
ucnkg	amtheqgeggkwlneqgrrjs
ucpab	amrrjqggwbkwjxjqgthes
udcle	aleggqhthekvwmgqhgshs
udfqg	albbeqhwmgkvtheqhjxjs
udnkg	altheqheggkvlneqhrrjs
udpab	alrrjqhgwbkvjxjqhthes
uecle	akeggqithekuwmgqigshs
uefqg	akbbeqiwmgkutheqijxjs
uenkg	aktheqieggkulneqirrjs
uepab	akrrjqigwbkujxjqithes
ufcle	ajeggqjthektwmgqjgshs
uffqg	ajbbeqjwmgkttheqjjxjs
ufnkg	ajtheqjeggktlneqjrrjs
ufpab	ajrrjqjgwbktjxjqjthes
ufrta	ajpykqjipakthekqjvads
ugcle	aieggqkthekswmgqkgshs
ugfqg	aibbeqkwmgkstheqkjxjs
ugnkg	aitheqkeggkslneqkrrjs
ugpab	airrjqkgwbksjxjqkthes
uhcle	aheggqlthekrwmgqlgshs
uhfqg	ahbbeqlwmgkrtheqljxjs
uhnkg	ahtheqleggkrlneqlrrjs
uhpab	ahrrjqlgwbkrjxjqlthes
uicle	ageggqmthekqwmgqmgshs
uifqg	agbbeqmwmgkqtheqmjxjs
uinkg	agtheqmeggkqlneqmrrjs
uipab	agrrjqmgwbkqjxjqmthes
ujcle	afeggqnthekpwmgqngshs
ujfqg	afbbeqnwmgkptheqnjxjs
ujnkg	aftheqneggkplneqnrrjs
ujpab	afrrjqngwbkpjxjqnthes
ukcle	aeeggqothekowmgqogshs
ukfqg	aebbeqowmgkotheqojxjs
uknkg	aetheqoeggkolneqorrjs
ukpab	aerrjqogwbkojxjqothes
ulcle	adeggqptheknwmgqpgshs
ulfqg	adbbeqpwmgkntheqpjxjs
ulnkg	adtheqpeggknlneqprrjs
ulpab	adrrjqpgwbknjxjqpthes
umcle	aceggqqthekmwmgqqgshs
umfqg	acbbeqqwmgkmtheqqjxjs
umnkg	actheqqeggkmlneqqrrjs
umpab	acrrjqqgwbkmjxjqqthes
uncle	abeggqrtheklwmgqrgshs
unfqg	abbbeqrwmgkltheqrjxjs
unnkg	abtheqreggkllneqrrrjs
unpab	abrrjqrgwbkljxjqrthes
uocle	aaeggqsthekkwmgqsgshs
uofqg	aabbeqswmgkktheqsjxjs
uonkg	aatheqseggkklneqsrrjs
uopab	aarrjqsgwbkkjxjqsthes
upcle	azeggqtthekjwmgqtgshs
updxa	azdukqtutakjvakqtheds
upfqg	azbbeqtwmgkjtheqtjxjs
upnkg	aztheqteggkjlneqtrrjs
uppab	azrrjqtgwbkjjxjqtthes
upqia	azqjkqtheakjipkqtupds
uqcle	ayeggquthekiwmgqugshs
uqfqg	aybbequwmgkithequjxjs
uqnkg	aythequeggkilnequrrjs
uqpab	ayrrjqugwbkijxjquthes
urcle	axeggqvthekhwmgqvgshs
urfqg	axbbeqvwmgkhtheqvjxjs
urnkg	axtheqveggkhlneqvrrjs
urpab	axrrjqvgwbkhjxjqvthes
uscle	aweggqwthekgwmgqwgshs
usfqg	awbbeqwwmgkgtheqwjxjs
usnkg	awtheqweggkglneqwrrjs
uspab	awrrjqwgwbkgjxjqwthes
utcle	aveggqxthekfwmgqxgshs
utfqg	avbbeqxwmgkftheqxjxjs
utnkg	avtheqxeggkflneqxrrjs
utpab	avrrjqxgwbkfjxjqxthes
uucle	aueggqythekewmgqygshs
uufqg	aubbeqywmgketheqyjxjs
uunkg	autheqyeggkelneqyrrjs
uupab	aurrjqygwbkejxjqythes
uvcle	ateggqzthekdwmgqzgshs
uvfqg	atbbeqzwmgkdtheqzjxjs
uvnkg	attheqzeggkdlneqzrrjs
uvpab	atrrjqzgwbkdjxjqzthes
uvzna	athekqzqjakdzkkqzduds
uwcle	aseggqathekcwmgqagshs
uwfqg	asbbeqawmgkctheqajxjs
uwnkg	astheqaeggkclneqarrjs
uwpab	asrrjqagwbkcjxjqathes
uxcle	areggqbthekbwmgqbgshs
uxfqg	arbbeqbwmgkbtheqbjxjs
uxnkg	artheqbeggkblneqbrrjs
uxpab	arrrjqbgwbkbjxjqbthes
uycle	aqeggqcthekawmgqcgshs
uyfqg	aqbbeqcwmgkatheqcjxjs
uynkg	aqtheqceggkalneqcrrjs
uypab	aqrrjqcgwbkajxjqcthes
uzcle	apeggqdthekzwmgqdgshs
uzfqg	apbbeqdwmgkztheqdjxjs
uznkg	aptheqdeggkzlneqdrrjs
uzpab	aprrjqdgwbkzjxjqdthes
vacle	zoeggrethejywmgregshr
vafqg	zobberewmgjytherejxjr
vankg	zothereeggjylnererrjr
vapab	zorrjregwbjyjxjrether
vbcle	zneggrfthejxwmgrfgshr
vbfqg	znbberfwmgjxtherfjxjr
vbnkg	zntherfeggjxlnerfrrjr
vbpab	znrrjrfgwbjxjxjrfther
vccle	zmeggrgthejwwmgrggshr
vcfqg	zmbbergwmgjwthergjxjr
vcnkg	zmthergeggjwlnergrrjr
vcpab	zmrrjrggwbjwjxjrgther
vdcle	zleggrhthejvwmgrhgshr
vdfqg	zlbberhwmgjvtherhjxjr
vdnkg	zltherheggjvlnerhrrjr
vdpab	zlrrjrhgwbjvjxjrhther
vecle	zkeggrithejuwmgrigshr
vefqg	zkbberiwmgjutherijxjr
venkg	zktherieggjulnerirrjr
vepab	zkrrjrigwbjujxjrither
vfcle	zjeggrjthejtwmgrjgshr
vffqg	zjbberjwmgjttherjjxjr
vfnkg	zjtherjeggjtlnerjrrjr
vfpab	zjrrjrjgwbjtjxjrjther
vfrta	zjpykrjipajthekrjvadr
vgcle	zieggrkthejswmgrkgshr
vgfqg	zibberkwmgjstherkjxjr
vgnkg	zitherkeggjslnerkrrjr
vgpab	zirrjrkgwbjsjxjrkther
vhcle	zheggrlthejrwmgrlgshr
vhfqg	zhbberlwmgjrtherljxjr
vhnkg	zhtherleggjrlnerlrrjr
vhpab	zhrrjrlgwbjrjxjrlther
vicle	zgeggrmthejqwmgrmgshr
vifqg	zgbbermwmgjqthermjxjr
vinkg	zgthermeggjqlnermrrjr
vipab	zgrrjrmgwbjqjxjrmther
vjcle	zfeggrnthejpwmgrngshr
vjfqg	zfbbernwmgjpthernjxjr
vjnkg	zftherneggjplnernrrjr
vjpab	zfrrjrngwbjpjxjrnther
vkcle	zeeggrothejowmgrogshr
vkfqg	zebberowmgjotherojxjr
vknkg	zetheroeggjolnerorrjr
vkpab	zerrjrogwbjojxjrother
vlcle	zdeggrpthejnwmgrpgshr
vlfqg	zdbberpwmgjntherpjxjr
vlnkg	zdtherpeggjnlnerprrjr
vlpab	zdrrjrpgwbjnjxjrpther
vmcle	zceggrqthejmwmgrqgshr
vmfqg	zcbberqwmgjmtherqjxjr
vmnkg	zctherqeggjmlnerqrrjr
vmpab	zcrrjrqgwbjmjxjrqther
vncle	zbeggrrthejlwmgrrgshr
vnfqg	zbbberrwmgjltherrjxjr
vnnkg	zbtherreggjllnerrrrjr
vnpab	zbrrjrrgwbjljxjrrther
vocle	zaeggrsthejkwmgrsgshr
vofqg	zabberswmgjkthersjxjr
vonkg	zatherseggjklnersrrjr
vopab	zarrjrsgwbjkjxjrsther
vpcle	zzeggrtthejjwmgrtgshr
vpdxa	zzdukrtutajjvakrthedr
vpfqg	zzbbertwmgjjthertjxjr
vpnkg	zztherteggjjlnertrrjr
vppab	zzrrjrtgwbjjjxjrtther
vpqia	zzqjkrtheajjipkrtupdr
vqcle	zyeggruthejiwmgrugshr
vqfqg	zybberuwmgjitherujxjr
vqnkg	zytherueggjilnerurrjr
vqpab	zyrrjrugwbjijxjruther
vrcle	zxeggrvthejhwmgrvgshr
vrfqg	zxbbervwmgjhthervjxjr
vrnkg	zxtherveggjhlnervrrjr
vrpab	zxrrjrvgwbjhjxjrvther
vscle	zweggrwthejgwmgrwgshr
vsfqg	zwbberwwmgjgtherwjxjr
vsnkg	zwtherweggjglnerwrrjr
vspab	zwrrjrwgwbjgjxjrwther
vtcle	zveggrxthejfwmgrxgshr
vtfqg	zvbberxwmgjftherxjxjr
vtnkg	zvtherxeggjflnerxrrjr
vtpab	zvrrjrxgwbjfjxjrxther
vucle	zueggrythejewmgrygshr
vufqg	zubberywmgjetheryjxjr
vunkg	zutheryeggjelneryrrjr
vupab	zurrjrygwbjejxjryther
vvcle	zteggrzthejdwmgrzgshr
vvfqg	ztbberzwmgjdtherzjxjr
vvnkg	zttherzeggjdlnerzrrjr
vvpab	ztrrjrzgwbjdjxjrzther
vvzna	zthekrzqjajdzkkrzdudr
vwcle	zseggrathejcwmgragshr
vwfqg	zsbberawmgjctherajxjr
vwnkg	zstheraeggjclnerarrjr
vwpab	zsrrjragwbjcjxjrather
vxcle	zreggrbthejbwmgrbgshr
vxfqg	zrbberbwmgjbtherbjxjr
vxnkg	zrtherbeggjblnerbrrjr
vxpab	zrrrjrbgwbjbjxjrbther
vycle	zqeggrcthejawmgrcgshr
vyfqg	zqbbercwmgjathercjxjr
vynkg	zqtherceggjalnercrrjr
vypab	zqrrjrcgwbjajxjrcther
vzcle	zpeggrdthejzwmgrdgshr
vzfqg	zpbberdwmgjztherdjxjr
vznkg	zptherdeggjzlnerdrrjr
vzpab	zprrjrdgwbjzjxjrdther
wacle	yoeggsetheiywmgsegshq
wafqg	yobbesewmgiythesejxjq
wankg	yotheseeggiylneserrjq
wapab	yorrjsegwbiyjxjsetheq
wbcle	yneggsftheixwmgsfgshq
wbfqg	ynbbesfwmgixthesfjxjq
wbnkg	ynthesfeggixlnesfrrjq
wbpab	ynrrjsfgwbixjxjsftheq
wccle	ymeggsgtheiwwmgsggshq
wcfqg	ymbbesgwmgiwthesgjxjq
wcnkg	ymthesgeggiwlnesgrrjq
wcpab	ymrrjsggwbiwjxjsgtheq
wdcle	yleggshtheivwmgshgshq
wdfqg	ylbbeshwmgivtheshjxjq
wdnkg	ylthesheggivlneshrrjq
wdpab	ylrrjshgwbivjxjshtheq
wecle	ykeggsitheiuwmgsigshq
wefqg	ykbbesiwmgiuthesijxjq
wenkg	ykthesieggiulnesirrjq
wepab	ykrrjsigwbiujxjsitheq
wfcle	yjeggsjtheitwmgsjgshq
wffqg	yjbbesjwmgitthesjjxjq
wfnkg	yjthesjeggitlnesjrrjq
wfpab	yjrrjsjgwbitjxjsjtheq
wfrta	yjpyksjipaitheksjvadq
wgcle	yieggsktheiswmgskgshq
wgfqg	yibbeskwmgistheskjxjq
wgnkg	yitheskeggislneskrrjq
wgpab	yirrjskgwbisjxjsktheq
whcle	yheggsltheirwmgslgshq
whfqg	yhbbeslwmgirthesljxjq
whnkg	yhthesleggirlneslrrjq
whpab	yhrrjslgwbirjxjsltheq
wicle	ygeggsmtheiqwmgsmgshq
wifqg	ygbbesmwmgiqthesmjxjq
winkg	ygthesmeggiqlnesmrrjq
wipab	ygrrjsmgwbiqjxjsmtheq
wjcle	yfeggsntheipwmgsngshq
wjfqg	yfbbesnwmgipthesnjxjq
wjnkg	yfthesneggiplnesnrrjq
wjpab	yfrrjsngwbipjxjsntheq
wkcle	yeeggsotheiowmgsogshq
wkfqg	yebbesowmgiothesojxjq
wknkg	yethesoeggiolnesorrjq
wkpab	yerrjsogwbiojxjsotheq
wlcle	ydeggsptheinwmgspgshq
wlfqg	ydbbespwmginthespjxjq
wlnkg	ydthespegginlnesprrjq
wlpab	ydrrjspgwbinjxjsptheq
wmcle	yceggsqtheimwmgsqgshq
wmfqg	ycbbesqwmgimthesqjxjq
wmnkg	ycthesqeggimlnesqrrjq
wmpab	ycrrjsqgwbimjxjsqtheq
wncle	ybeggsrtheilwmgsrgshq
wnfqg	ybbbesrwmgilthesrjxjq
wnnkg	ybthesreggillnesrrrjq
wnpab	ybrrjsrgwbiljxjsrtheq
wocle	yaeggsstheikwmgssgshq
wofqg	yabbesswmgikthessjxjq
wonkg	yathesseggiklnessrrjq
wopab	yarrjssgwbikjxjsstheq
wpcle	yzeggsttheijwmgstgshq
wpdxa	yzdukstutaijvaksthedq
wpfqg	yzbbestwmgijthestjxjq
wpnkg	yzthesteggijlnestrrjq
wppab	yzrrjstgwbijjxjsttheq
wpqia	yzqjkstheaijipkstupdq
wqcle	yyeggsutheiiwmgsugshq
wqfqg	yybbesuwmgiithesujxjq
wqnkg	yythesueggiilnesurrjq
wqpab	yyrrjsugwbiijxjsutheq
wrcle	yxeggsvtheihwmgsvgshq
wrfqg	yxbbesvwmgihthesvjxjq
wrnkg	yxthesveggihlnesvrrjq
wrpab	yxrrjsvgwbihjxjsvtheq
wscle	yweggswtheigwmgswgshq
wsfqg	ywbbeswwmgigtheswjxjq
wsnkg	ywthesweggiglneswrrjq
wspab	ywrrjswgwbigjxjswtheq
wtcle	yveggsxtheifwmgsxgshq
wtfqg	yvbbesxwmgifthesxjxjq
wtnkg	yvthesxeggiflnesxrrjq
wtpab	yvrrjsxgwbifjxjsxtheq
wucle	yueggsytheiewmgsygshq
wufqg	yubbesywmgiethesyjxjq
wunkg	yuthesyeggielnesyrrjq
wupab	yurrjsygwbiejxjsytheq
wvcle	yteggsztheidwmgszgshq
wvfqg	ytbbeszwmgidtheszjxjq
wvnkg	yttheszeggidlneszrrjq
wvpab	ytrrjszgwbidjxjsztheq
wvzna	ythekszqjaidzkkszdudq
wwcle	yseggsatheicwmgsagshq
wwfqg	ysbbesawmgicthesajxjq
wwnkg	ysthesaeggiclnesarrjq
wwpab	ysrrjsagwbicjxjsatheq
wxcle	yreggsbtheibwmgsbgshq
wxfqg	yrbbesbwmgibthesbjxjq
wxnkg	yrthesbeggiblnesbrrjq
wxpab	yrrrjsbgwbibjxjsbtheq
wycle	yqeggsctheiawmgscgshq
wyfqg	yqbbescwmgiathescjxjq
wynkg	yqthesceggialnescrrjq
wypab	yqrrjscgwbiajxjsctheq
wzcle	ypeggsdtheizwmgsdgshq
wzfqg	ypbbesdwmgizthesdjxjq
wznkg	ypthesdeggizlnesdrrjq
wzpab	yprrjsdgwbizjxjsdtheq
xacle	xoeggtethehywmgtegshp
xafqg	xobbetewmghythetejxjp
xankg	xotheteegghylneterrjp
xapab	xorrjtegwbhyjxjtethep
xbcle	xneggtfthehxwmgtfgshp
xbfqg	xnbbetfwmghxthetfjxjp
xbnkg	xnthetfegghxlnetfrrjp
xbpab	xnrrjtfgwbhxjxjtfthep
xccle	xmeggtgthehwwmgtggshp
xcfqg	xmbbetgwmghwthetgjxjp
xcnkg	xmthetgegghwlnetgrrjp
xcpab	xmrrjtggwbhwjxjtgthep
xdaaa	xlgrkthrwahvyxkthehdp
xdaba	xlgqkthrxahvywktheidp
xdaca	xlgpkthryahvyvkthejdp
xdada	xlgokthrzahvyukthekdp
xdaea	xlgnkthraahvytktheldp
xdafa	xlgmkthrbahvyskthemdp
xdaga	xlglkthrcahvyrkthendp
xdaha	xlgkkthrdahvyqktheodp
xdaia	xlgjkthreahvypkthepdp
xdaja	xlgikthrfahvyoktheqdp
xdaka	xlghkthrgahvynktherdp
xdala	xlggkthrhahvymkthesdp
xdama	xlgfkthriahvylkthetdp
xdana	xlgekthrjahvykktheudp
xdaoa	xlgdkthrkahvyjkthevdp
xdapa	xlgckthrlahvyikthewdp
xdaqa	xlgbkthrmahvyhkthexdp
xdara	xlgakthrnahvygktheydp
xdasa	xlgzkthroahvyfkthezdp
xdata	xlgykthrpahvyektheadp
xdaua	xlgxkthrqahvydkthebdp
xdava	xlgwkthrrahvyckthecdp
xdawa	xlgvkthrsahvybktheddp
xdaxa	xlgukthrtahvyaktheedp
xdaya	xlgtkthruahvyzkthefdp
xdaza	xlgskthrvahvyykthegdp
xdcle	xleggththehvwmgthgshp
xdfqg	xlbbethwmghvthethjxjp
xdnaa	xltrkthewahvlxkthrhdp
xdnba	xltqkthexahvlwkthridp
xdnca	xltpktheyahvlvkthrjdp
xdnda	xltokthezahvlukthrkdp
xdnea	xltnktheaahvltkthrldp
xdnfa	xltmkthebahvlskthrmdp
xdnga	xltlkthecahvlrkthrndp
xdnha	xltkkthedahvlqkthrodp
xdnia	xltjktheeahvlpkthrpdp
xdnja	xltikthefahvlokthrqdp
xdnka	xlthkthegahvlnkthrrdp
xdnla	xltgkthehahvlmkthrsdp
xdnma	xltfktheiahvllkthrtdp
xdnna	xltekthejahvlkkthrudp
xdnoa	xltdkthekahvljkthrvdp
xdnpa	xltckthelahvlikthrwdp
xdnqa	xltbkthemahvlhkthrxdp
xdnra	xltakthenahvlgkthrydp
xdnsa	xltzktheoahvlfkthrzdp
xdnta	xltykthepahvlekthradp
xdnua	xltxktheqahvldkthrbdp
xdnva	xltwktherahvlckthrcdp
xdnwa	xltvkthesahvlbkthrddp
xdnxa	xltukthetahvlakthredp
xdnya	xlttktheuahvlzkthrfdp
xdnza	xltskthevahvlykthrgdp
xdpab	xlrrjthgwbhvjxjththep
xecle	xkeggtithehuwmgtigshp
xefqg	xkbbetiwmghuthetijxjp
xenkg	xkthetiegghulnetirrjp
xepab	xkrrjtigwbhujxjtithep
xfcle	xjeggtjthehtwmgtjgshp
xffqg	xjbbetjwmghtthetjjxjp
xfnkg	xjthetjegghtlnetjrrjp
xfpab	xjrrjtjgwbhtjxjtjthep
xfrta	xjpyktjipahthektjvadp
xgcle	xieggtkthehswmgtkgshp
xgfqg	xibbetkwmghsthetkjxjp
xgnkg	xithetkegghslnetkrrjp
xgpab	xirrjtkgwbhsjxjtkthep
xhcle	xheggtlthehrwmgtlgshp
xhfqg	xhbbetlwmghrthetljxjp
xhnkg	xhthetlegghrlnetlrrjp
xhpab	xhrrjtlgwbhrjxjtlthep
xicle	xgeggtmthehqwmgtmgshp
xifqg	xgbbetmwmghqthetmjxjp
xinkg	xgthetmegghqlnetmrrjp
xipab	xgrrjtmgwbhqjxjtmthep
xjcle	xfeggtnthehpwmgtngshp
xjfqg	xfbbetnwmghpthetnjxjp
xjnkg	xfthetnegghplnetnrrjp
xjpab	xfrrjtngwbhpjxjtnthep
xkcle	xeeggtothehowmgtogshp
xkfqg	xebbetowmghothetojxjp
xknkg	xethetoeggholnetorrjp
xkpab	xerrjtogwbhojxjtothep
xlcle	xdeggtpthehnwmgtpgshp
xlfqg	xdbbetpwmghnthetpjxjp
xlnkg	xdthetpegghnlnetprrjp
xlpab	xdrrjtpgwbhnjxjtpthep
xmcle	xceggtqthehmwmgtqgshp
xmfqg	xcbbetqwmghmthetqjxjp
xmnkg	xcthetqegghmlnetqrrjp
xmpab	xcrrjtqgwbhmjxjtqthep
xncle	xbeggtrthehlwmgtrgshp
xnfqg	xbbbetrwmghlthetrjxjp
xnnkg	xbthetregghllnetrrrjp
xnpab	xbrrjtrgwbhljxjtrthep
xocle	xaeggtsthehkwmgtsgshp
xofqg	xabbetswmghkthetsjxjp
xonkg	xathetsegghklnetsrrjp
xopab	xarrjtsgwbhkjxjtsthep
xpcle	xzeggttthehjwmgttgshp
xpdxa	xzdukttutahjvaktthedp
xpfqg	xzbbettwmghjthettjxjp
xpnkg	xzthettegghjlnettrrjp
xppab	xzrrjttgwbhjjxjttthep
xpqia	xzqjkttheahjipkttupdp
xqcle	xyeggtuthehiwmgtugshp
xqfqg	xybbetuwmghithetujxjp
xqnkg	xythetuegghilneturrjp
xqpab	xyrrjtugwbhijxjtuthep
xrcle	xxeggtvthehhwmgtvgshp
xrfqg	xxbbetvwmghhthetvjxjp
xrnkg	xxthetvegghhlnetvrrjp
xrpab	xxrrjtvgwbhhjxjtvthep
xscle	xweggtwthehgwmgtwgshp
xsfqg	xwbbetwwmghgthetwjxjp
xsnkg	xwthetwegghglnetwrrjp
xspab	xwrrjtwgwbhgjxjtwthep
xtcle	xveggtxthehfwmgtxgshp
xtfqg	xvbbetxwmghfthetxjxjp
xtnkg	xvthetxegghflnetxrrjp
xtpab	xvrrjtxgwbhfjxjtxthep
xuaat	xugrrtyrwtheyxrtyehwp
xuabt	xugqrtyrxtheywrtyeiwp
xuact	xugprtyrytheyvrtyejwp
xuadt	xugortyrztheyurtyekwp
xuaet	xugnrtyratheytrtyelwp
xuaft	xugmrtyrbtheysrtyemwp
xuagt	xuglrtyrctheyrrtyenwp
xuaht	xugkrtyrdtheyqrtyeowp
xuait	xugjrtyretheyprtyepwp
xuajt	xugirtyrftheyortyeqwp
xuakt	xughrtyrgtheynrtyerwp
xualt	xuggrtyrhtheymrtyeswp
xuamt	xugfrtyritheylrtyetwp
xuant	xugertyrjtheykrtyeuwp
xuaot	xugdrtyrktheyjrtyevwp
xuapt	xugcrtyrltheyirtyewwp
xuaqt	xugbrtyrmtheyhrtyexwp
xuart	xugartyrntheygrtyeywp
xuast	xugzrtyrotheyfrtyezwp
xuatt	xugyrtyrptheyertyeawp
xuaut	xugxrtyrqtheydrtyebwp
xuavt	xugwrtyrrtheycrtyecwp
xuawt	xugvrtyrstheybrtyedwp
xuaxt	xugurtyrttheyartyeewp
xuayt	xugtrtyrutheyzrtyefwp
xuazt	xugsrtyrvtheyyrtyegwp
xubat	xufrrtyswthexxrtyfhwp
xubbt	xufqrtysxthexwrtyfiwp
xubct	xufprtysythexvrtyfjwp
xubdt	xufortyszthexurtyfkwp
xubet	xufnrtysathextrtyflwp
xubft	xufmrtysbthexsrtyfmwp
xubgt	xuflrtyscthexrrtyfnwp
xubht	xufkrtysdthexqrtyfowp
xubit	xufjrtysethexprtyfpwp
xubjt	xufirtysfthexortyfqwp
xubkt	xufhrtysgthexnrtyfrwp
xublt	xufgrtyshthexmrtyfswp
xubmt	xuffrtysithexlrtyftwp
xubnt	xufertysjthexkrtyfuwp
xubot	xufdrtyskthexjrtyfvwp
xubpt	xufcrtyslthexirtyfwwp
xubqt	xufbrtysmthexhrtyfxwp
xubrt	xufartysnthexgrtyfywp
xubst	xufzrtysothexfrtyfzwp
xubtt	xufyrtyspthexertyfawp
xubut	xufxrtysqthexdrtyfbwp
xubvt	xufwrtysrthexcrtyfcwp
xubwt	xufvrtyssthexbrtyfdwp
xubxt	xufurtystthexartyfewp
xubyt	xuftrtysuthexzrtyffwp
xubzt	xufsrtysvthexyrtyfgwp
xucat	xuerrtytwthewxrtyghwp
xucbt	xueqrtytxthewwrtygiwp
xucct	xueprtytythewvrtygjwp
xucdt	xueortytzthewurtygkwp
xucet	xuenrtytathewtrtyglwp
xucft	xuemrtytbthewsrtygmwp
xucgt	xuelrtytcthewrrtygnwp
xucht	xuekrtytdthewqrtygowp
xucit	xuejrtytethewprtygpwp
xucjt	xueirtytfthewortygqwp
xuckt	xuehrtytgthewnrtygrwp
xucle	xueggtythehewmgtygshp
xucmt	xuefrtytithewlrtygtwp
xucnt	xueertytjthewkrtyguwp
xucot	xuedrtytkthewjrtygvwp
xucpt	xuecrtytlthewirtygwwp
xucqt	xuebrtytmthewhrtygxwp
xucrt	xueartytnthewgrtygywp
xucst	xuezrtytothewfrtygzwp
xuctt	xueyrtytpthewertygawp
xucut	xuexrtytqthewdrtygbwp
xucvt	xuewrtytrthewcrtygcwp
xucwt	xuevrtytsthewbrtygdwp
xucxt	xueurtyttthewartygewp
xucyt	xuetrtytuthewzrtygfwp
xuczt	xuesrtytvthewyrtyggwp
xudat	xudrrtyuwthevxrtyhhwp
xudbt	xudqrtyuxthevwrtyhiwp
xudct	xudprtyuythevvrtyhjwp
xuddt	xudortyuzthevurtyhkwp
xudet	xudnrtyuathevtrtyhlwp
xudft	xudmrtyubthevsrtyhmwp
xudgt	xudlrtyucthevrrtyhnwp
xudht	xudkrtyudthevqrtyhowp
xudit	xudjrtyuethevprtyhpwp
xudjt	xudirtyufthevortyhqwp
xudkt	xudhrtyugthevnrtyhrwp
xudlt	xudgrtyuhthevmrtyhswp
xudmt	xudfrtyuithevlrtyhtwp
xudnt	xudertyujthevkrtyhuwp
xudot	xuddrtyukthevjrtyhvwp
xudpt	xudcrtyulthevirtyhwwp
xudqt	xudbrtyumthevhrtyhxwp
xudrt	xudartyunthevgrtyhywp
xudst	xudzrtyuothevfrtyhzwp
xudtt	xudyrtyupthevertyhawp
xudut	xudxrtyuqthevdrtyhbwp
xudvt	xudwrtyurthevcrtyhcwp
xudwt	xudvrtyusthevbrtyhdwp
xudxt	xudurtyutthevartyhewp
xudyt	xudtrtyuuthevzrtyhfwp
xudzt	xudsrtyuvthevyrtyhgwp
xueat	xucrrtyvwtheuxrtyihwp
xuebt	xucqrtyvxtheuwrtyiiwp
xuect	xucprtyvytheuvrtyijwp
xuedt	xucortyvztheuurtyikwp
xueet	xucnrtyvatheutrtyilwp
xueft	xucmrtyvbtheusrtyimwp
xuegt	xuclrtyvctheurrtyinwp
xueht	xuckrtyvdtheuqrtyiowp
xueit	xucjrtyvetheuprtyipwp
xuejt	xucirtyvftheuortyiqwp
xuekt	xuchrtyvgtheunrtyirwp
xuelt	xucgrtyvhtheumrtyiswp
xuemt	xucfrtyvitheulrtyitwp
xuent	xucertyvjtheukrtyiuwp
xueot	xucdrtyvktheujrtyivwp
xuept	xuccrtyvltheuirtyiwwp
xueqt	xucbrtyvmtheuhrtyixwp
xuert	xucartyvntheugrtyiywp
xuest	xuczrtyvotheufrtyizwp
xuett	xucyrtyvptheuertyiawp
xueut	xucxrtyvqtheudrtyibwp
xuevt	xucwrtyvrtheucrtyicwp
xuewt	xucvrtyvstheubrtyidwp
xuext	xucurtyvttheuartyiewp
xueyt	xuctrtyvutheuzrtyifwp
xuezt	xucsrtyvvtheuyrtyigwp
xufat	xubrrtywwthetxrtyjhwp
xufbt	xubqrtywxthetwrtyjiwp
xufct	xubprtywythetvrtyjjwp
xufdt	xubortywztheturtyjkwp
xufet	xubnrtywathettrtyjlwp
xufft	xubmrtywbthetsrtyjmwp
xufgt	xublrtywcthetrrtyjnwp
xufht	xubkrtywdthetqrtyjowp
xufit	xubjrtywethetprtyjpwp
xufjt	xubirtywfthetortyjqwp
xufkt	xubhrtywgthetnrtyjrwp
xuflt	xubgrtywhthetmrtyjswp
xufmt	xubfrtywithetlrtyjtwp
xufnt	xubertywjthetkrtyjuwp
xufot	xubdrtywkthetjrtyjvwp
xufpt	xubcrtywlthetirtyjwwp
xufqg	xubbetywmghethetyjxjp
xufrt	xubartywnthetgrtyjywp
xufst	xubzrtywothetfrtyjzwp
xuftt	xubyrtywpthetertyjawp
xufut	xubxrtywqthetdrtyjbwp
xufvt	xubwrtywrthetcrtyjcwp
xufwt	xubvrtywsthetbrtyjdwp
xufxt	xuburtywtthetartyjewp
xufyt	xubtrtywuthetzrtyjfwp
xufzt	xubsrtywvthetyrtyjgwp
xugat	xuarrtyxwthesxrtykhwp
xugbt	xuaqrtyxxtheswrtykiwp
xugct	xuaprtyxythesvrtykjwp
xugdt	xuaortyxzthesurtykkwp
xuget	xuanrtyxathestrtyklwp
xugft	xuamrtyxbthessrtykmwp
xuggt	xualrtyxcthesrrtyknwp
xught	xuakrtyxdthesqrtykowp
xugit	xuajrtyxethesprtykpwp
xugjt	xuairtyxfthesortykqwp
xugkt	xuahrtyxgthesnrtykrwp
xuglt	xuagrtyxhthesmrtykswp
xugmt	xuafrtyxitheslrtyktwp
xugnt	xuaertyxjtheskrtykuwp
xugot	xuadrtyxkthesjrtykvwp
xugpt	xuacrtyxlthesirtykwwp
xugqt	xuabrtyxmtheshrtykxwp
xugrt	xuaartyxnthesgrtykywp
xugst	xuazrtyxothesfrtykzwp
xugtt	xuayrtyxpthesertykawp
xugut	xuaxrtyxqthesdrtykbwp
xugvt	xuawrtyxrthescrtykcwp
xugwt	xuavrtyxsthesbrtykdwp
xugxt	xuaurtyxtthesartykewp
xugyt	xuatrtyxutheszrtykfwp
xugzt	xuasrtyxvthesyrtykgwp
xuhat	xuzrrtyywtherxrtylhwp
xuhbt	xuzqrtyyxtherwrtyliwp
xuhct	xuzprtyyythervrtyljwp
xuhdt	xuzortyyztherurtylkwp
xuhet	xuznrtyyathertrtyllwp
xuhft	xuzmrtyybthersrtylmwp
xuhgt	xuzlrtyyctherrrtylnwp
xuhht	xuzkrtyydtherqrtylowp
xuhit	xuzjrtyyetherprtylpwp
xuhjt	xuzirtyyftherortylqwp
xuhkt	xuzhrtyygthernrtylrwp
xuhlt	xuzgrtyyhthermrtylswp
xuhmt	xuzfrtyyitherlrtyltwp
xuhnt	xuzertyyjtherkrtyluwp
xuhot	xuzdrtyyktherjrtylvwp
xuhpt	xuzcrtyyltherirtylwwp
xuhqt	xuzbrtyymtherhrtylxwp
xuhrt	xuzartyynthergrtylywp
xuhst	xuzzrtyyotherfrtylzwp
xuhtt	xuzyrtyyptherertylawp
xuhut	xuzxrtyyqtherdrtylbwp
xuhvt	xuzwrtyyrthercrtylcwp
xuhwt	xuzvrtyystherbrtyldwp
xuhxt	xuzurtyyttherartylewp
xuhyt	xuztrtyyutherzrtylfwp
xuhzt	xuzsrtyyvtheryrtylgwp
xuiat	xuyrrtyzwtheqxrtymhwp
xuibt	xuyqrtyzxtheqwrtymiwp
xuict	xuyprtyzytheqvrtymjwp
xuidt	xuyortyzzthequrtymkwp
xuiet	xuynrtyzatheqtrtymlwp
xuift	xuymrtyzbtheqsrtymmwp
xuigt	xuylrtyzctheqrrtymnwp
xuiht	xuykrtyzdtheqqrtymowp
xuiit	xuyjrtyzetheqprtympwp
xuijt	xuyirtyzftheqortymqwp
xuikt	xuyhrtyzgtheqnrtymrwp
xuilt	xuygrtyzhtheqmrtymswp
xuimt	xuyfrtyzitheqlrtymtwp
xuint	xuyertyzjtheqkrtymuwp
xuiot	xuydrtyzktheqjrtymvwp
xuipt	xuycrtyzltheqirtymwwp
xuiqt	xuybrtyzmtheqhrtymxwp
xuirt	xuyartyzntheqgrtymywp
xuist	xuyzrtyzotheqfrtymzwp
xuitt	xuyyrtyzptheqertymawp
xuiut	xuyxrtyzqtheqdrtymbwp
xuivt	xuywrtyzrtheqcrtymcwp
xuiwt	xuyvrtyzstheqbrtymdwp
xuixt	xuyurtyzttheqartymewp
xuiyt	xuytrtyzutheqzrtymfwp
xuizt	xuysrtyzvtheqyrtymgwp
xujat	xuxrrtyawthepxrtynhwp
xujbt	xuxqrtyaxthepwrtyniwp
xujct	xuxprtyaythepvrtynjwp
xujdt	xuxortyazthepurtynkwp
xujet	xuxnrtyaatheptrtynlwp
xujft	xuxmrtyabthepsrtynmwp
xujgt	xuxlrtyactheprrtynnwp
xujht	xuxkrtyadthepqrtynowp
xujit	xuxjrtyaethepprtynpwp
xujjt	xuxirtyaftheportynqwp
xujkt	xuxhrtyagthepnrtynrwp
xujlt	xuxgrtyahthepmrtynswp
xujmt	xuxfrtyaitheplrtyntwp
xujnt	xuxertyajthepkrtynuwp
xujot	xuxdrtyakthepjrtynvwp
xujpt	xuxcrtyalthepirtynwwp
xujqt	xuxbrtyamthephrtynxwp
xujrt	xuxartyanthepgrtynywp
xujst	xuxzrtyaothepfrtynzwp
xujtt	xuxyrtyapthepertynawp
xujut	xuxxrtyaqthepdrtynbwp
xujvt	xuxwrtyarthepcrtyncwp
xujwt	xuxvrtyasthepbrtyndwp
xujxt	xuxurtyatthepartynewp
xujyt	xuxtrtyauthepzrtynfwp
xujzt	xuxsrtyavthepyrtyngwp
xukat	xuwrrtybwtheoxrtyohwp
xukbt	xuwqrtybxtheowrtyoiwp
xukct	xuwprtybytheovrtyojwp
xukdt	xuwortybztheourtyokwp
xuket	xuwnrtybatheotrtyolwp
xukft	xuwmrtybbtheosrtyomwp
xukgt	xuwlrtybctheorrtyonwp
xukht	xuwkrtybdtheoqrtyoowp
xukit	xuwjrtybetheoprtyopwp
xukjt	xuwirtybftheoortyoqwp
xukkt	xuwhrtybgtheonrtyorwp
xuklt	xuwgrtybhtheomrtyoswp
xukmt	xuwfrtybitheolrtyotwp
xuknt	xuwertybjtheokrtyouwp
xukot	xuwdrtybktheojrtyovwp
xukpt	xuwcrtybltheoirtyowwp
xukqt	xuwbrtybmtheohrtyoxwp
xukrt	xuwartybntheogrtyoywp
xukst	xuwzrtybotheofrtyozwp
xuktt	xuwyrtybptheoertyoawp
xukut	xuwxrtybqtheodrtyobwp
xukvt	xuwwrtybrtheocrtyocwp
xukwt	xuwvrtybstheobrtyodwp
xukxt	xuwurtybttheoartyoewp
xukyt	xuwtrtybutheozrtyofwp
xukzt	xuwsrtybvtheoyrtyogwp
xulat	xuvrrtycwthenxrtyphwp
xulbt	xuvqrtycxthenwrtypiwp
xulct	xuvprtycythenvrtypjwp
xuldt	xuvortyczthenurtypkwp
xulet	xuvnrtycathentrtyplwp
xulft	xuvmrtycbthensrtypmwp
xulgt	xuvlrtyccthenrrtypnwp
xulht	xuvkrtycdthenqrtypowp
xulit	xuvjrtycethenprtyppwp
xuljt	xuvirtycfthenortypqwp
xulkt	xuvhrtycgthennrtyprwp
xullt	xuvgrtychthenmrtypswp
xulmt	xuvfrtycithenlrtyptwp
xulnt	xuvertycjthenkrtypuwp
xulot	xuvdrtyckthenjrtypvwp
xulpt	xuvcrtyclthenirtypwwp
xulqt	xuvbrtycmthenhrtypxwp
xulrt	xuvartycnthengrtypywp
xulst	xuvzrtycothenfrtypzwp
xultt	xuvyrtycpthenertypawp
xulut	xuvxrtycqthendrtypbwp
xulvt	xuvwrtycrthencrtypcwp
xulwt	xuvvrtycsthenbrtypdwp
xulxt	xuvurtyctthenartypewp
xulyt	xuvtrtycuthenzrtypfwp
xulzt	xuvsrtycvthenyrtypgwp
xumat	xuurrtydwthemxrtyqhwp
xumbt	xuuqrtydxthemwrtyqiwp
xumct	xuuprtydythemvrtyqjwp
xumdt	xuuortydzthemurtyqkwp
xumet	xuunrtydathemtrtyqlwp
xumft	xuumrtydbthemsrtyqmwp
xumgt	xuulrtydcthemrrtyqnwp
xumht	xuukrtyddthemqrtyqowp
xumit	xuujrtydethemprtyqpwp
xumjt	xuuirtydfthemortyqqwp
xumkt	xuuhrtydgthemnrtyqrwp
xumlt	xuugrtydhthemmrtyqswp
xummt	xuufrtydithemlrtyqtwp
xumnt	xuuertydjthemkrtyquwp
xumot	xuudrtydkthemjrtyqvwp
xumpt	xuucrtydlthemirtyqwwp
xumqt	xuubrtydmthemhrtyqxwp
xumrt	xuuartydnthemgrtyqywp
xumst	xuuzrtydothemfrtyqzwp
xumtt	xuuyrtydpthemertyqawp
xumut	xuuxrtydqthemdrtyqbwp
xumvt	xuuwrtydrthemcrtyqcwp
xumwt	xuuvrtydsthembrtyqdwp
xumxt	xuuurtydtthemartyqewp
xumyt	xuutrtyduthemzrtyqfwp
xumzt	xuusrtydvthemyrtyqgwp
xunat	xutrrtyewthelxrtyrhwp
xunbt	xutqrtyexthelwrtyriwp
xunct	xutprtyeythelvrtyrjwp
xundt	xutortyezthelurtyrkwp
xunet	xutnrtyeatheltrtyrlwp
xunft	xutmrtyebthelsrtyrmwp
xungt	xutlrtyecthelrrtyrnwp
xunht	xutkrtyedthelqrtyrowp
xunit	xutjrtyeethelprtyrpwp
xunjt	xutirtyefthelortyrqwp
xunkg	xuthetyegghelnetyrrjp
xunlt	xutgrtyehthelmrtyrswp
xunmt	xutfrtyeithellrtyrtwp
xunnt	xutertyejthelkrtyruwp
xunot	xutdrtyektheljrtyrvwp
xunpt	xutcrtyelthelirtyrwwp
xunqt	xutbrtyemthelhrtyrxwp
xunrt	xutartyenthelgrtyrywp
xunst	xutzrtyeothelfrtyrzwp
xuntt	xutyrtyepthelertyrawp
xunut	xutxrtyeqtheldrtyrbwp
xunvt	xutwrtyerthelcrtyrcwp
xunwt	xutvrtyesthelbrtyrdwp
xunxt	xuturtyetthelartyrewp
xunyt	xuttrtyeuthelzrtyrfwp
xunzt	xutsrtyevthelyrtyrgwp
xuoat	xusrrtyfwthekxrtyshwp
xuobt	xusqrtyfxthekwrtysiwp
xuoct	xusprtyfythekvrtysjwp
xuodt	xusortyfzthekurtyskwp
xuoet	xusnrtyfathektrtyslwp
xuoft	xusmrtyfbtheksrtysmwp
xuogt	xuslrtyfcthekrrtysnwp
xuoht	xuskrtyfdthekqrtysowp
xuoit	xusjrtyfethekprtyspwp
xuojt	xusirtyffthekortysqwp
xuokt	xushrtyfgtheknrtysrwp
xuolt	xusgrtyfhthekmrtysswp
xuomt	xusfrtyfitheklrtystwp
xuont	xusertyfjthekkrtysuwp
xuoot	xusdrtyfkthekjrtysvwp
xuopt	xuscrtyflthekirtyswwp
xuoqt	xusbrtyfmthekhrtysxwp
xuort	xusartyfnthekgrtysywp
xuost	xuszrtyfothekfrtyszwp
xuott	xusyrtyfpthekertysawp
xuout	xusxrtyfqthekdrtysbwp
xuovt	xuswrtyfrthekcrtyscwp
xuowt	xusvrtyfsthekbrtysdwp
xuoxt	xusurtyftthekartysewp
xuoyt	xustrtyfuthekzrtysfwp
xuozt	xussrtyfvthekyrtysgwp
xupab	xurrjtygwbhejxjtythep
xupbt	xurqrtygxthejwrtytiwp
xupct	xurprtygythejvrtytjwp
xupdt	xurortygzthejurtytkwp
xupet	xurnrtygathejtrtytlwp
xupft	xurmrtygbthejsrtytmwp
xupgt	xurlrtygcthejrrtytnwp
xupht	xurkrtygdthejqrtytowp
xupit	xurjrtygethejprtytpwp
xupjt	xurirtygfthejortytqwp
xupkt	xurhrtyggthejnrtytrwp
xuplt	xurgrtyghthejmrtytswp
xupmt	xurfrtygithejlrtyttwp
xupnt	xurertygjthejkrtytuwp
xupot	xurdrtygkthejjrtytvwp
xuppt	xurcrtyglthejirtytwwp
xupqt	xurbrtygmthejhrtytxwp
xuprt	xurartygnthejgrtytywp
xupst	xurzrtygothejfrtytzwp
xuptt	xuryrtygpthejertytawp
xuput	xurxrtygqthejdrtytbwp
xupvt	xurwrtygrthejcrtytcwp
xupwt	xurvrtygsthejbrtytdwp
xupxt	xururtygtthejartytewp
xupyt	xurtrtyguthejzrtytfwp
xupzt	xursrtygvthejyrtytgwp
xuqat	xuqrrtyhwtheixrtyuhwp
xuqbt	xuqqrtyhxtheiwrtyuiwp
xuqct	xuqprtyhytheivrtyujwp
xuqdt	xuqortyhztheiurtyukwp
xuqet	xuqnrtyhatheitrtyulwp
xuqft	xuqmrtyhbtheisrtyumwp
xuqgt	xuqlrtyhctheirrtyunwp
xuqht	xuqkrtyhdtheiqrtyuowp
xuqit	xuqjrtyhetheiprtyupwp
xuqjt	xuqirtyhftheiortyuqwp
xuqkt	xuqhrtyhgtheinrtyurwp
xuqlt	xuqgrtyhhtheimrtyuswp
xuqmt	xuqfrtyhitheilrtyutwp
xuqnt	xuqertyhjtheikrtyuuwp
xuqot	xuqdrtyhktheijrtyuvwp
xuqpt	xuqcrtyhltheiirtyuwwp
xuqqt	xuqbrtyhmtheihrtyuxwp
xuqrt	xuqartyhntheigrtyuywp
xuqst	xuqzrtyhotheifrtyuzwp
xuqtt	xuqyrtyhptheiertyuawp
xuqut	xuqxrtyhqtheidrtyubwp
xuqvt	xuqwrtyhrtheicrtyucwp
xuqwt	xuqvrtyhstheibrtyudwp
xuqxt	xuqurtyhttheiartyuewp
xuqyt	xuqtrtyhutheizrtyufwp
xuqzt	xuqsrtyhvtheiyrtyugwp
xurat	xuprrtyiwthehxrtyvhwp
xurbt	xupqrtyixthehwrtyviwp
xurct	xupprtyiythehvrtyvjwp
xurdt	xuportyizthehurtyvkwp
xuret	xupnrtyiathehtrtyvlwp
xurft	xupmrtyibthehsrtyvmwp
xurgt	xuplrtyicthehrrtyvnwp
xurht	xupkrtyidthehqrtyvowp
xurit	xupjrtyiethehprtyvpwp
xurjt	xupirtyifthehortyvqwp
xurkt	xuphrtyigthehnrtyvrwp
xurlt	xupgrtyihthehmrtyvswp
xurmt	xupfrtyiithehlrtyvtwp
xurnt	xupertyijthehkrtyvuwp
xurot	xupdrtyikthehjrtyvvwp
xurpt	xupcrtyilthehirtyvwwp
xurqt	xupbrtyimthehhrtyvxwp
xurrt	xupartyinthehgrtyvywp
xurst	xupzrtyiothehfrtyvzwp
xurtt	xupyrtyipthehertyvawp
xurut	xupxrtyiqthehdrtyvbwp
xurvt	xupwrtyirthehcrtyvcwp
xurwt	xupvrtyisthehbrtyvdwp
xurxt	xupurtyitthehartyvewp
xuryt	xuptrtyiuthehzrtyvfwp
xurzt	xupsrtyivthehyrtyvgwp
xusat	xuorrtyjwthegxrtywhwp
xusbt	xuoqrtyjxthegwrtywiwp
xusct	xuoprtyjythegvrtywjwp
xusdt	xuoortyjzthegurtywkwp
xuset	xuonrtyjathegtrtywlwp
xusft	xuomrtyjbthegsrtywmwp
xusgt	xuolrtyjcthegrrtywnwp
xusht	xuokrtyjdthegqrtywowp
xusit	xuojrtyjethegprtywpwp
xusjt	xuoirtyjfthegortywqwp
xuskt	xuohrtyjgthegnrtywrwp
xuslt	xuogrtyjhthegmrtywswp
xusmt	xuofrtyjitheglrtywtwp
xusnt	xuoertyjjthegkrtywuwp
xusot	xuodrtyjkthegjrtywvwp
xuspt	xuocrtyjlthegirtywwwp
xusqt	xuobrtyjmtheghrtywxwp
xusrt	xuoartyjntheggrtywywp
xusst	xuozrtyjothegfrtywzwp
xustt	xuoyrtyjpthegertywawp
xusut	xuoxrtyjqthegdrtywbwp
xusvt	xuowrtyjrthegcrtywcwp
xuswt	xuovrtyjsthegbrtywdwp
xusxt	xuourtyjtthegartywewp
xusyt	xuotrtyjuthegzrtywfwp
xuszt	xuosrtyjvthegyrtywgwp
xutat	xunrrtykwthefxrtyxhwp
xutbt	xunqrtykxthefwrtyxiwp
xutct	xunprtykythefvrtyxjwp
xutdt	xunortykzthefurtyxkwp
xutet	xunnrtykatheftrtyxlwp
xutft	xunmrtykbthefsrtyxmwp
xutgt	xunlrtykcthefrrtyxnwp
xutht	xunkrtykdthefqrtyxowp
xutit	xunjrtykethefprtyxpwp
xutjt	xunirtykfthefortyxqwp
xutkt	xunhrtykgthefnrtyxrwp
xutlt	xungrtykhthefmrtyxswp
xutmt	xunfrtykitheflrtyxtwp
xutnt	xunertykjthefkrtyxuwp
xutot	xundrtykkthefjrtyxvwp
xutpt	xuncrtyklthefirtyxwwp
xutqt	xunbrtykmthefhrtyxxwp
xutrt	xunartyknthefgrtyxywp
xutst	xunzrtykotheffrtyxzwp
xuttt	xunyrtykpthefertyxawp
xutut	xunxrtykqthefdrtyxbwp
xutvt	xunwrtykrthefcrtyxcwp
xutwt	xunvrtyksthefbrtyxdwp
xutxt	xunurtyktthefartyxewp
xutyt	xuntrtykuthefzrtyxfwp
xutzt	xunsrtykvthefyrtyxgwp
xuuat	xumrrtylwtheexrtyyhwp
xuubt	xumqrtylxtheewrtyyiwp
xuuct	xumprtylytheevrtyyjwp
xuudt	xumortylztheeurtyykwp
xuuet	xumnrtylatheetrtyylwp
xuuft	xummrtylbtheesrtyymwp
xuugt	xumlrtylctheerrtyynwp
xuuht	xumkrtyldtheeqrtyyowp
xuuit	xumjrtyletheeprtyypwp
xuujt	xumirtylftheeortyyqwp
xuukt	xumhrtylgtheenrtyyrwp
xuult	xumgrtylhtheemrtyyswp
xuumt	xumfrtylitheelrtyytwp
xuunt	xumertyljtheekrtyyuwp
xuuot	xumdrtylktheejrtyyvwp
xuupt	xumcrtylltheeirtyywwp
xuuqt	xumbrtylmtheehrtyyxwp
xuurt	xumartylntheegrtyyywp
xuust	xumzrtylotheefrtyyzwp
xuutt	xumyrtylptheeertyyawp
xuuut	xumxrtylqtheedrtyybwp
xuuvt	xumwrtylrtheecrtyycwp
xuuwt	xumvrtylstheebrtyydwp
xuuxt	xumurtylttheeartyyewp
xuuyt	xumtrtylutheezrtyyfwp
xuuzt	xumsrtylvtheeyrtyygwp
xuvat	xulrrtymwthedxrtyzhwp
xuvbt	xulqrtymxthedwrtyziwp
xuvct	xulprtymythedvrtyzjwp
xuvdt	xulortymzthedurtyzkwp
xuvet	xulnrtymathedtrtyzlwp
xuvft	xulmrtymbthedsrtyzmwp
xuvgt	xullrtymcthedrrtyznwp
xuvht	xulkrtymdthedqrtyzowp
xuvit	xuljrtymethedprtyzpwp
xuvjt	xulirtymfthedortyzqwp
xuvkt	xulhrtymgthednrtyzrwp
xuvlt	xulgrtymhthedmrtyzswp
xuvmt	xulfrtymithedlrtyztwp
xuvnt	xulertymjthedkrtyzuwp
xuvot	xuldrtymkthedjrtyzvwp
xuvpt	xulcrtymlthedirtyzwwp
xuvqt	xulbrtymmthedhrtyzxwp
xuvrt	xulartymnthedgrtyzywp
xuvst	xulzrtymothedfrtyzzwp
xuvtt	xulyrtympthedertyzawp
xuvut	xulxrtymqtheddrtyzbwp
xuvvt	xulwrtymrthedcrtyzcwp
xuvwt	xulvrtymsthedbrtyzdwp
xuvxt	xulurtymtthedartyzewp
xuvyt	xultrtymuthedzrtyzfwp
xuvzt	xulsrtymvthedyrtyzgwp
xuwat	xukrrtynwthecxrtyahwp
xuwbt	xukqrtynxthecwrtyaiwp
xuwct	xukprtynythecvrtyajwp
xuwdt	xukortynzthecurtyakwp
xuwet	xuknrtynathectrtyalwp
xuwft	xukmrtynbthecsrtyamwp
xuwgt	xuklrtyncthecrrtyanwp
xuwht	xukkrtyndthecqrtyaowp
xuwit	xukjrtynethecprtyapwp
xuwjt	xukirtynfthecortyaqwp
xuwkt	xukhrtyngthecnrtyarwp
xuwlt	xukgrtynhthecmrtyaswp
xuwmt	xukfrtynitheclrtyatwp
xuwnt	xukertynjtheckrtyauwp
xuwot	xukdrtynkthecjrtyavwp
xuwpt	xukcrtynlthecirtyawwp
xuwqt	xukbrtynmthechrtyaxwp
xuwrt	xukartynnthecgrtyaywp
xuwst	xukzrtynothecfrtyazwp
xuwtt	xukyrtynpthecertyaawp
xuwut	xukxrtynqthecdrtyabwp
xuwvt	xukwrtynrtheccrtyacwp
xuwwt	xukvrtynsthecbrtyadwp
xuwxt	xukurtyntthecartyaewp
xuwyt	xuktrtynutheczrtyafwp
xuwzt	xuksrtynvthecyrtyagwp
xuxat	xujrrtyowthebxrtybhwp
xuxbt	xujqrtyoxthebwrtybiwp
xuxct	xujprtyoythebvrtybjwp
xuxdt	xujortyoztheburtybkwp
xuxet	xujnrtyoathebtrtyblwp
xuxft	xujmrtyobthebsrtybmwp
xuxgt	xujlrtyocthebrrtybnwp
xuxht	xujkrtyodthebqrtybowp
xuxit	xujjrtyoethebprtybpwp
xuxjt	xujirtyofthebortybqwp
xuxkt	xujhrtyogthebnrtybrwp
xuxlt	xujgrtyohthebmrtybswp
xuxmt	xujfrtyoitheblrtybtwp
xuxnt	xujertyojthebkrtybuwp
xuxot	xujdrtyokthebjrtybvwp
xuxpt	xujcrtyolthebirtybwwp
xuxqt	xujbrtyomthebhrtybxwp
xuxrt	xujartyonthebgrtybywp
xuxst	xujzrtyoothebfrtybzwp
xuxtt	xujyrtyopthebertybawp
xuxut	xujxrtyoqthebdrtybbwp
xuxvt	xujwrtyorthebcrtybcwp
xuxwt	xujvrtyosthebbrtybdwp
xuxxt	xujurtyotthebartybewp
xuxyt	xujtrtyouthebzrtybfwp
xuxzt	xujsrtyovthebyrtybgwp
xuyat	xuirrtypwtheaxrtychwp
xuybt	xuiqrtypxtheawrtyciwp
xuyct	xuiprtypytheavrtycjwp
xuydt	xuiortypztheaurtyckwp
xuyet	xuinrtypatheatrtyclwp
xuyft	xuimrtypbtheasrtycmwp
xuygt	xuilrtypcthearrtycnwp
xuyht	xuikrtypdtheaqrtycowp
xuyit	xuijrtypetheaprtycpwp
xuyjt	xuiirtypftheaortycqwp
xuykt	xuihrtypgtheanrtycrwp
xuylt	xuigrtyphtheamrtycswp
xuymt	xuifrtypithealrtyctwp
xuynt	xuiertypjtheakrtycuwp
xuyot	xuidrtypktheajrtycvwp
xuypt	xuicrtypltheairtycwwp
xuyqt	xuibrtypmtheahrtycxwp
xuyrt	xuiartypntheagrtycywp
xuyst	xuizrtypotheafrtyczwp
xuytt	xuiyrtypptheaertycawp
xuyut	xuixrtypqtheadrtycbwp
xuyvt	xuiwrtyprtheacrtyccwp
xuywt	xuivrtypstheabrtycdwp
xuyxt	xuiurtypttheaartycewp
xuyyt	xuitrtyputheazrtycfwp
xuyzt	xuisrtypvtheayrtycgwp
xuzat	xuhrrtyqwthezxrtydhwp
xuzbt	xuhqrtyqxthezwrtydiwp
xuzct	xuhprtyqythezvrtydjwp
xuzdt	xuhortyqzthezurtydkwp
xuzet	xuhnrtyqatheztrtydlwp
xuzft	xuhmrtyqbthezsrtydmwp
xuzgt	xuhlrtyqcthezrrtydnwp
xuzht	xuhkrtyqdthezqrtydowp
xuzit	xuhjrtyqethezprtydpwp
xuzjt	xuhirtyqfthezortydqwp
xuzkt	xuhhrtyqgtheznrtydrwp
xuzlt	xuhgrtyqhthezmrtydswp
xuzmt	xuhfrtyqithezlrtydtwp
xuznt	xuhertyqjthezkrtyduwp
xuzot	xuhdrtyqkthezjrtydvwp
xuzpt	xuhcrtyqlthezirtydwwp
xuzqt	xuhbrtyqmthezhrtydxwp
xuzrt	xuhartyqnthezgrtydywp
xuzst	xuhzrtyqothezfrtydzwp
xuztt	xuhyrtyqpthezertydawp
xuzut	xuhxrtyqqthezdrtydbwp
xuzvt	xuhwrtyqrthezcrtydcwp
xuzwt	xuhvrtyqsthezbrtyddwp
xuzxt	xuhurtyqtthezartydewp
xuzyt	xuhtrtyquthezzrtydfwp
xuzzt	xuhsrtyqvthezyrtydgwp
xvcle	xteggtzthehdwmgtzgshp
xvfqg	xtbbetzwmghdthetzjxjp
xvnkg	xtthetzegghdlnetzrrjp
xvpab	xtrrjtzgwbhdjxjtzthep
xvzna	xthektzqjahdzkktzdudp
xwcle	xseggtathehcwmgtagshp
xwfqg	xsbbetawmghcthetajxjp
xwnkg	xsthetaegghclnetarrjp
xwpab	xsrrjtagwbhcjxjtathep
xxcle	xreggtbthehbwmgtbgshp
xxfqg	xrbbetbwmghbthetbjxjp
xxnkg	xrthetbegghblnetbrrjp
xxpab	xrrrjtbgwbhbjxjtbthep
xycle	xqeggtcthehawmgtcgshp
xyfqg	xqbbetcwmghathetcjxjp
xynkg	xqthetcegghalnetcrrjp
xypab	xqrrjtcgwbhajxjtcthep
xzcle	xpeggtdthehzwmgtdgshp
xzfqg	xpbbetdwmghzthetdjxjp
xznkg	xpthetdegghzlnetdrrjp
xzpab	xprrjtdgwbhzjxjtdthep
yacle	woegguethegywmguegsho
yafqg	wobbeuewmggytheuejxjo
yankg	wotheueegggylneuerrjo
yapab	worrjuegwbgyjxjuetheo
ybcle	wneggufthegxwmgufgsho
ybfqg	wnbbeufwmggxtheufjxjo
ybnkg	wntheufegggxlneufrrjo
ybpab	wnrrjufgwbgxjxjuftheo
yccle	wmeggugthegwwmguggsho
ycfqg	wmbbeugwmggwtheugjxjo
ycnkg	wmtheugegggwlneugrrjo
ycpab	wmrrjuggwbgwjxjugtheo
ydcle	wlegguhthegvwmguhgsho
ydfqg	wlbbeuhwmggvtheuhjxjo
ydnkg	wltheuhegggvlneuhrrjo
ydpab	wlrrjuhgwbgvjxjuhtheo
yecle	wkegguitheguwmguigsho
yefqg	wkbbeuiwmggutheuijxjo
yenkg	wktheuiegggulneuirrjo
yepab	wkrrjuigwbgujxjuitheo
yfcle	wjeggujthegtwmgujgsho
yffqg	wjbbeujwmggttheujjxjo
yfnkg	wjtheujegggtlneujrrjo
yfpab	wjrrjujgwbgtjxjujtheo
yfrta	wjpykujipagthekujvado
ygcle	wieggukthegswmgukgsho
ygfqg	wibbeukwmggstheukjxjo
ygnkg	witheukegggslneukrrjo
ygpab	wirrjukgwbgsjxjuktheo
yhcle	wheggulthegrwmgulgsho
yhfqg	whbbeulwmggrtheuljxjo
yhnkg	whtheulegggrlneulrrjo
yhpab	whrrjulgwbgrjxjultheo
yicle	wgeggumthegqwmgumgsho
yifqg	wgbbeumwmggqtheumjxjo
yinkg	wgtheumegggqlneumrrjo
yipab	wgrrjumgwbgqjxjumtheo
yjcle	wfeggunthegpwmgungsho
yjfqg	wfbbeunwmggptheunjxjo
yjnkg	wftheunegggplneunrrjo
yjpab	wfrrjungwbgpjxjuntheo
ykcle	weegguothegowmguogsho
ykfqg	webbeuowmggotheuojxjo
yknkg	wetheuoegggolneuorrjo
ykpab	werrjuogwbgojxjuotheo
ylcle	wdeggupthegnwmgupgsho
ylfqg	wdbbeupwmggntheupjxjo
ylnkg	wdtheupegggnlneuprrjo
ylpab	wdrrjupgwbgnjxjuptheo
ymcle	wcegguqthegmwmguqgsho
ymfqg	wcbbeuqwmggmtheuqjxjo
ymnkg	wctheuqegggmlneuqrrjo
ympab	wcrrjuqgwbgmjxjuqtheo
yncle	wbeggurtheglwmgurgsho
ynfqg	wbbbeurwmggltheurjxjo
ynnkg	wbtheuregggllneurrrjo
ynpab	wbrrjurgwbgljxjurtheo
yocle	waeggusthegkwmgusgsho
yofqg	wabbeuswmggktheusjxjo
yonkg	watheusegggklneusrrjo
yopab	warrjusgwbgkjxjustheo
ypcle	wzeggutthegjwmgutgsho
ypdxa	wzdukututagjvakuthedo
ypfqg	wzbbeutwmggjtheutjxjo
ypnkg	wztheutegggjlneutrrjo
yppab	wzrrjutgwbgjjxjuttheo
ypqia	wzqjkutheagjipkutupdo
yqcle	wyegguuthegiwmguugsho
yqfqg	wybbeuuwmggitheuujxjo
yqnkg	wytheuuegggilneuurrjo
yqpab	wyrrjuugwbgijxjuutheo
yrcle	wxegguvtheghwmguvgsho
yrfqg	wxbbeuvwmgghtheuvjxjo
yrnkg	wxtheuveggghlneuvrrjo
yrpab	wxrrjuvgwbghjxjuvtheo
yscle	wwegguwtheggwmguwgsho
ysfqg	wwbbeuwwmgggtheuwjxjo
ysnkg	wwtheuwegggglneuwrrjo
yspab	wwrrjuwgwbggjxjuwtheo
ytcle	wvegguxthegfwmguxgsho
ytfqg	wvbbeuxwmggftheuxjxjo
ytnkg	wvtheuxegggflneuxrrjo
ytpab	wvrrjuxgwbgfjxjuxtheo
yucle	wuegguythegewmguygsho
yufqg	wubbeuywmggetheuyjxjo
yunkg	wutheuyegggelneuyrrjo
yupab	wurrjuygwbgejxjuytheo
yvcle	wtegguzthegdwmguzgsho
yvfqg	wtbbeuzwmggdtheuzjxjo
yvnkg	wttheuzegggdlneuzrrjo
yvpab	wtrrjuzgwbgdjxjuztheo
yvzna	wthekuzqjagdzkkuzdudo
ywcle	wsegguathegcwmguagsho
ywfqg	wsbbeuawmggctheuajxjo
ywnkg	wstheuaegggclneuarrjo
ywpab	wsrrjuagwbgcjxjuatheo
yxcle	wreggubthegbwmgubgsho
yxfqg	wrbbeubwmggbtheubjxjo
yxnkg	wrtheubegggblneubrrjo
yxpab	wrrrjubgwbgbjxjubtheo
yycle	wqeggucthegawmgucgsho
yyfqg	wqbbeucwmggatheucjxjo
yynkg	wqtheucegggalneucrrjo
yypab	wqrrjucgwbgajxjuctheo
yzcle	wpeggudthegzwmgudgsho
yzfqg	wpbbeudwmggztheudjxjo
yznkg	wptheudegggzlneudrrjo
yzpab	wprrjudgwbgzjxjudtheo
zacle	voeggvethefywmgvegshn
zafqg	vobbevewmgfythevejxjn
zankg	votheveeggfylneverrjn
zapab	vorrjvegwbfyjxjvethen
zbcle	vneggvfthefxwmgvfgshn
zbfqg	vnbbevfwmgfxthevfjxjn
zbnkg	vnthevfeggfxlnevfrrjn
zbpab	vnrrjvfgwbfxjxjvfthen
zccle	vmeggvgthefwwmgvggshn
zcfqg	vmbbevgwmgfwthevgjxjn
zcnkg	vmthevgeggfwlnevgrrjn
zcpab	vmrrjvggwbfwjxjvgthen
zdcle	vleggvhthefvwmgvhgshn
zdfqg	vlbbevhwmgfvthevhjxjn
zdnkg	vlthevheggfvlnevhrrjn
zdpab	vlrrjvhgwbfvjxjvhthen
zecle	vkeggvithefuwmgvigshn
zefqg	vkbbeviwmgfuthevijxjn
zenkg	vkthevieggfulnevirrjn
zepab	vkrrjvigwbfujxjvithen
zfcle	vjeggvjtheftwmgvjgshn
zffqg	vjbbevjwmgftthevjjxjn
zfnkg	vjthevjeggftlnevjrrjn
zfpab	vjrrjvjgwbftjxjvjthen
zfrta	vjpykvjipafthekvjvadn
zgcle	vieggvkthefswmgvkgshn
zgfqg	vibbevkwmgfsthevkjxjn
zgnkg	vithevkeggfslnevkrrjn
zgpab	virrjvkgwbfsjxjvkthen
zhcle	vheggvlthefrwmgvlgshn
zhfqg	vhbbevlwmgfrthevljxjn
zhnkg	vhthevleggfrlnevlrrjn
zhpab	vhrrjvlgwbfrjxjvlthen
zicle	vgeggvmthefqwmgvmgshn
zifqg	vgbbevmwmgfqthevmjxjn
zinkg	vgthevmeggfqlnevmrrjn
zipab	vgrrjvmgwbfqjxjvmthen
zjcle	vfeggvnthefpwmgvngshn
zjfqg	vfbbevnwmgfpthevnjxjn
zjnkg	vfthevneggfplnevnrrjn
zjpab	vfrrjvngwbfpjxjvnthen
zkcle	veeggvothefowmgvogshn
zkfqg	vebbevowmgfothevojxjn
zknkg	vethevoeggfolnevorrjn
zkpab	verrjvogwbfojxjvothen
zlcle	vdeggvpthefnwmgvpgshn
zlfqg	vdbbevpwmgfnthevpjxjn
zlnkg	vdthevpeggfnlnevprrjn
zlpab	vdrrjvpgwbfnjxjvpthen
zmcle	vceggvqthefmwmgvqgshn
zmfqg	vcbbevqwmgfmthevqjxjn
zmnkg	vcthevqeggfmlnevqrrjn
zmpab	vcrrjvqgwbfmjxjvqthen
zncle	vbeggvrtheflwmgvrgshn
znfqg	vbbbevrwmgflthevrjxjn
znnkg	vbthevreggfllnevrrrjn
znpab	vbrrjvrgwbfljxjvrthen
zocle	vaeggvsthefkwmgvsgshn
zofqg	vabbevswmgfkthevsjxjn
zonkg	vathevseggfklnevsrrjn
zopab	varrjvsgwbfkjxjvsthen
zpcle	vzeggvtthefjwmgvtgshn
zpdxa	vzdukvtutafjvakvthedn
zpfqg	vzbbevtwmgfjthevtjxjn
zpnkg	vzthevteggfjlnevtrrjn
zppab	vzrrjvtgwbfjjxjvtthen
zpqia	vzqjkvtheafjipkvtupdn
zqcle	vyeggvuthefiwmgvugshn
zqfqg	vybbevuwmgfithevujxjn
zqnkg	vythevueggfilnevurrjn
zqpab	vyrrjvugwbfijxjvuthen
zrcle	vxeggvvthefhwmgvvgshn
zrfqg	vxbbevvwmgfhthevvjxjn
zrnkg	vxthevveggfhlnevvrrjn
zrpab	vxrrjvvgwbfhjxjvvthen
zscle	vweggvwthefgwmgvwgshn
zsfqg	vwbbevwwmgfgthevwjxjn
zsnkg	vwthevweggfglnevwrrjn
zspab	vwrrjvwgwbfgjxjvwthen
ztcle	vveggvxtheffwmgvxgshn
ztfqg	vvbbevxwmgffthevxjxjn
ztnkg	vvthevxeggfflnevxrrjn
ztpab	vvrrjvxgwbffjxjvxthen
zucle	vueggvythefewmgvygshn
zufqg	vubbevywmgfethevyjxjn
zunkg	vuthevyeggfelnevyrrjn
zupab	vurrjvygwbfejxjvythen
zvcle	vteggvzthefdwmgvzgshn
zvfqg	vtbbevzwmgfdthevzjxjn
zvnkg	vtthevzeggfdlnevzrrjn
zvpab	vtrrjvzgwbfdjxjvzthen
zvzna	vthekvzqjafdzkkvzdudn
zwcle	vseggvathefcwmgvagshn
zwfqg	vsbbevawmgfcthevajxjn
zwnkg	vsthevaeggfclnevarrjn
zwpab	vsrrjvagwbfcjxjvathen
zxcle	vreggvbthefbwmgvbgshn
zxfqg	vrbbevbwmgfbthevbjxjn
zxnkg	vrthevbeggfblnevbrrjn
zxpab	vrrrjvbgwbfbjxjvbthen
zycle	vqeggvcthefawmgvcgshn
zyfqg	vqbbevcwmgfathevcjxjn
zynkg	vqthevceggfalnevcrrjn
zypab	vqrrjvcgwbfajxjvcthen
zzcle	vpeggvdthefzwmgvdgshn
zzfqg	vpbbevdwmgfzthevdjxjn
zznkg	vpthevdeggfzlnevdrrjn
zzpab	vprrjvdgwbfzjxjvdthen
